
Acaia → Roble
Aito → Alto
Anil → Azul
Ankraro → Loco
Arcana → Arcano
Arima → Coral
Asunna → Caseta
Atria → Abedul
Auriava → Río de oro
Avistela → Mirador
Bankexette → Banquero
Bianco → Blanco
Britaxette → Panadero
Brixante → Brillante
Bulanere → Bufón
Calvo → Calvo
Campelette → Campanero
Cauginno → pequeño carcelero
Dultse → Dulce
Ebande → Búho
Elme → Olmo
Emelo → Guapo
Epikar → Épico
Equalo → Igual
Esneaxette → Lechero
Foko → Fuego
Fola → Hoja
Forno → Horno
Grazero → Gracioso
Hali → Majo
Herfola → Hoja de hierro
Herren → De hierro
Herro → Hierro
Hidranyea → Hidrángea
Honito → Hombre nocturno
Igernasunna → Casa vieja
Igerne → Viejo
Intresola (Sn significad)
Introverto → Introvertido
Jefe → Jefe
Joglar → Juglar
Jokaiette→ Jugador
Kanala → Canal
Karnirette → Carnicero
Kasa → Casa
Kempoloi → Campo de amor
Koasta → Costa
Koastutso → Costa de marfil
Kolfisi → Tundra
Kolorit → Colores
Koraiso → Corazón
Korko → Corcho
Koxinette → Cocinero
Kraba → Cangrejo
Kraiette → Criada
Laiette → Persona de ley
Loi → Amor
Madra → Madera
Madracaia → Madera de roble
Madrakuxette, Madrera → Leñador
Magna, Grata → Grande
Marit → Mares
Materra → Tierra madre
Mende → Mente
Mistica → Místico
Musikette → Músico
Nevo → Nuevo
Nevorein → Nuevo rey
Nito → Noche
Peskorette → Pescador
Peskoventeie → Pescadero
Petrohon → Hombre de piedra
Petroit → Piedras
Petroxette → Cantero
Pikoler → Menor
Praisoxette → Sacerdote
Purro → Porro
Qiava → Carcaj
Rante → Rápido
Rein → Rey
Renno → Reino
Rinka → Anillo
Ritsa → Rico
Roixa → Rosa
Roxo → Rojo
Securo → Seguro
Sela → Sonrisa
Sugarra → Vago
Sundo → Profundo
Sunriava → Río profundo
Triai → Tres
Ugro → Lodo
Untsua → Caoba
Vatio → Vacío
Vita → Vida
Xiabeloso → Divertido
Xikorra → Buitre
Zigar → Burro