a punto de terminar → afinale
abalconado → evokinde
abandonado → ekoreko
abaratar → atsai
abierto → apero, aipreoso
abisal → abysal
abismal → oxtuoro
abollado → hundiko
abominable → abominable, abomeineko
abonado (dinero) → abonako
abonado (tierra) → tsesako
abonado → abonoko
abordado → aborrako
abortado → abortado
abrasivo → abrasivo
abrazado → hogoko
absoluto → absoluto
abstenido → absteno
abstracto → abstracto
abstruso → abstruso
abundante → abonte
aburrido → aborrado
acabado → bertse
académico → akademiko
accesible → akcesibla
aceitoso → asoaso
acogedor → akaino
acompañado → exekoro
activo → aktivo
actual → airpose
actualizado → airposaioko
acuático → acoatiko
acusado → akusako
adictivo → adiktoso
adicto → adikto
adoptado → adopto
afilado → alfilago
afónico → afono
afortunado → helera
agradecido → grazeio
agresivo → agresibo
agrio → xigro
albino → albino
alcanzado → arran
aleatorio → rungo
alineado → aliniato
alternativo → anternaiko
alterno → alternaso
alto → aito
altruista → altruista
alzado → anco
amargado → tsagrioso
amargo → tsagrio
amenazador → zroto
amenazante → zrote
amistoso → amikeso
amplio → amplero
anáglifo → anaglifa
anárquico → anarqiko
ancho → faldo
anclado → anclaioto
anidado → ineste
anterior → andonko, prevo
antiguo → antio
antipático → antimaiso
anual → yaroko
apagado → unlite, off
arcano → arcana
ardiente → igneoso
áspero → coarsa
astuto → astuta
atrapado → zentso
aturdido → xake
aturdidor → xakoro
avaricioso → avarito
avergonzado → combrako
avisado → avisto, avistoko
bajo → pikoso
barato → atsoso
batido → socremeko
bélico → beliko
bello → belo
beneficioso → benefitioso
benigno → bainxo
bienvenido → bainaro
blando → bloneto
bloqueado → lokeioto
bonito → piloko
borracho → trunko
borroso → fizo
brillante → brixante
brusco → zizenno
bucal → oupare
buen → Baine
bueno → baine
cabezón, terco (insulto) → bluta
cabrón → fuzo
caducado → expiro
caduco → caduco
caliente → kalerkoso
callado → unpaireoso
calmado → calmo
calvo → calvo
cansado → infizo
capaz → abil
capitalista → capitalista
carismático → tsarismatiko
caritativo → karitatoso
carnoso → karnoso
caro → karo
casero → simanata, domodoio
castigado → jusaioto
catastrófico → combo
cautivo → kautivita
centenario → ozenoso
central → zentral
cerrado → kerraiso
ciego → blinda
científico → cientsifika
cierto (especificando algo) → certo
claro → klaro
clásico → eclasiko
claustrofóbico → claustrofobico
cocido → kozido
cocinado → koxineioto, koiko
colindante → colinte
colonizado → coloniko
coloquial → coloqio
colorido → kolorido
comburente → comburente
comercial → komerziale
cómodo → conforte
compatible → kompatible
complejo → complekso
completo → kompleto
complicado → complico
comprobado → teste
común → komuna
comunista → comunista
condenado → condeno
conectado → conekto
confundido → afuska
congelado → gelatio
conjugado → conjugo
conocido → miseioko
conocido, descubierto → aonato
conquistado → conqisto
consecutivo → consecutiva
conseguido → elokre
constante → constanto
contagioso → conteposa
contaminado → drigo, poluto
continuista → enderizo
convertido → konversaioko
cornudo → cornato
correcto → correcto, korrektoko
cortés → karaoso
corto → coto
creativo → creativo
crujiente → crusto
culpable → riaxeso
culto → litero
cultural → kultural, virian
curioso → kurioso
de la mañana → lamanza
de la noche → lanito
de la tarde → lataren
de un futuro cercano → postmoderna
de una ciudad; que está muy iluminada por la noche; llena de carteles y luces; similar a las representacione que se suelen hacer de tokyo → tokiota
débil → debila
decente → dezente
deficiente → defizente
definido → definite
definitivo → definite
dejado → dexaireioko
delgado → delekio
delicioso → delikoso
demócrata → democrato
democrático → democratika
derretido → fundo, derretido, derrito
derrotado → derroqo
derrotista → derroqista
desastroso → disastroso
desbloqueado → unlokeioto
descalzo → unpoie, unpoiro
desconocido → unmiseioko
desechado → desexo
deshecho → undono
desnudo → abiare
destacado → boldako
determinada → determina
diagonal → diagonal
diario → hena
dietético → dieteko
diferente → nequalo
diferido → difero
difícil → derrenko
digital → digital
dinámico → dinamika
directo → dirijtiko
discreto → diskreto
disponible → disve
disruptivo → disruptivo
distante → distante
distópico → distopica
divertido → xiabeloso
doctoral → doktoralo
dolido → dolo
doloroso → dolido
doméstico → domestixo
dudoso →  dubido
dulce → dultse
duro → tsosto
ecológico → ecologike
efectivo → efektibo
eficiente → efizente
eléctrico → elektriko
electrónico → elektrikono
emocionado → emozaio
emocionante → emozante
emotivo → emotivo
empanado → ebrite
empático → maise
empollón → cixe
encendido → on, lite
encerado → equo
encerrado → rekluido
endeudado → dutiako
enfadado → rutsuko
enfermo → ebilo
entero → folo, ello
enterrado → auro, enterro
enterrado vivo → vitauro
épico → epikar
ergonómico → ergonomo
esmaltado → esmaro
especial → espezial
espectral → espectora
espeso → hexego
esquemático → eskemeko
estafador → lerrako
estimar → estimai
estrecho → tino
estresado → anorrako
estresante → anorrieren
estropeado → errairiko
etéreo → etereo
eterno → ertseko
exacto → xakto
excesivo → posmo
expirado → expiro
explosivo → explodiko
expuesto → exposto
extinto → extingo
extraño → estranno
extremadamente bondadoso → estelegaze
extremo → extremo
extrovertido → extroverto
fácil → fazilo
fácilmente rompible → rompable
fallido → erro
falso → fakro
falto → fala
favorito → favo
feliz, alegre → aibelo
femenino → femenine
feo → zunno, zonno, utego
festivo → ferivo
ficticio → fikto
filoso → filaso
finito → finiko
fino → estretso
forzado → forzaioso
fragil → fragile
fresco (cuando se trata de algo novedoso) → siske, heruo, fresko
fresco → fresko
frío → aigeloso
frito → frito
fuerte → forte
galáctico → galaksiko
gandúl → sugarriyo
general → general
genial → genelo
glotón, goloso → glutonno
gracioso → grazero
grande → grata, oxto, magna
gratis → atsoko
grave → grave
grosero → uskoro
grueso → groso
gruñón, cabezota → bocarro
guapo → emelo
guay → yuolo, colo, legal
habilidoso → estiloso				
hambriento → fameno
hipnotizado → hipnoto
hogareño → heigaro
horizontal → horizono
horrible, terrible → terruo
húmedo → hemo
húmedo y profundo → heruo
ignorado → unviso
igual → equalo
ilimitado → unlimiteko
imaginador → imagineiko
importante → hembo, mora
imposible → imposibla
impresionable → impresable
impresionante → impresivo
impreso → izkratoso
inaccesible → inakcesibla
incluido → includo
incómodo → inconforte
incompatible → unkompatible
incorrecto → incorrecto, inkorrektoko
increíble → incredibla, unbeleizibla, unbelizabla
inculto → unlitero
indecente → undezente
industrial → industriala, industrial
infinito → unfiniko
infravalorado → aurvaluako
inmediato → imediato
inmortal → inmortal
inmune → inmuno
inocente → inocente
inoloro → eslofala
insaciable → insatiable
instantáneo → instantako
insular → insular
intelectual → intelektualo
intencional → intentiente
interesante → interesanta
introvertido → introverto
inundado → fluve
invisible → invisibla
irascible → ruztarrette
irónico → ironiko
irritado → ezirutsuko
irrompible → unrompable
jerárquico → jiderarqiko
jodida → frikenko
joven (adjetivo) → nevako
justo → iusto
kafkiano → kafkiano
lácteo → esneoro
lagrimado → lakrimido
lamiando → lamino
largo → longo
lascivo → invikso
legal → legal
legendario → legendario
lejano → foreno
lento → lento, levo
leve → leve
libre → libero, liberso
ligero → lito
limitado → limiteko
limpio → likraiso
linguisitico → langoko
listo (persona inteligente) → listo
listo (preparado) → estedie, preparato
literal → literal
llamado → llamako
lleno → ello, elloko
lleno de bondad → bainido
lleno de maldad → heunido
lleno de vida → vitido
local → local, locatako
loco → loko, ankraro, friko
lujoso → luxoso
lujurioso → luxurio                  
mágica → magika
mágico → haio, magiko
magnético → magnetiso
majo → hali
mal → heun
malasombra → heuntsado
maldito → mairato
maldito → maldito
maligno → heunxo
malo → heune
maloliente → heunesle
manchado → zugro
manco → falman
maniático → maniaco
manipulado, manipulable → maniketa
manipulador → manikete
marchito → marxito
marcial → martiala
marino → marine
más que perfecto → plusquamperfecta
masculino → masculine
masivo → masivo
maximo → oxtorra
mayor → oxtorer
medicinal → medikarer
mediocre → mediocre 
menor → pikoler
mental → mental
mentira → musta
mentiroso → mustager
mestizo → seutse
minúsculo → miskolo
mirado → avisoko
mismo → mesmo
misterioso → edariko
místico → mistica
moderno → moderna
modificado → modifikako
monetario → monetareo
mono → neko
morado → morato
mortal → mortal
mudo → unpaireko
muerto → morto
mugroso → mugaro
mundial → mondola
musical → musikal
muy cerrado, casi sin ventanas o puertas → zakerro
nacional → agizan
natural → naturala
necesario → traio
negativo → nekativo, nekatiko
nevado → aigeloso
no nublado, despejado (cielo) → lito
normal → normal
nublado → nimboso
nuclear → nuzelar
nuevo → nevo
obvio → obeo
occidental → ocidental
oculto → jido
ocupado → osalo
ocupado → osalo
ofensivo → ofensoko
oloroso → eslo
olvidado → supardo, oblivo, husko
óptimo → optima
oriental → oriental
original → origelo
orwelliano → orwelliana
oscuro → obskuro, auskura, unlita
oscuro y depresivo → ausko
oxidado (de hacer algo) → rigi
oxidado (metal) → ragiko
paquete (insulto) → tsusta
paralelo → paralelo
pasado → pasato
pasteurizado → pausteriko
pastoso → pastoso
patriótico → onterriko
pausado → pauxaioko
peligroso → perilko
pelotudo → pilotufeso
pensador → penzeiette
pensativo → penseivo
pequeño → pikolo, meno
perdido (no tiene esperanza) → unaikalo
perdido → pardeyoso
perezoso (persona) → fiago, fago
perfecto → perfekto
periódico → yere
permanente → unfinaloko
permitido → permisaioto
perpendicular → perpendicular
personal → personal
personal → pertsonala
personalizado → personalia 
pesado (persona molesta) → orronko
pesado (peso de una cosa) → pesoko
pestilente, pestoso → pestoso
plano → plano
pobre → pora
podrido → putro, joro
polar → polare
portátil → porto, portatil
poseído → poseso
posible → posibla
posterior → enterier
precioso → aibinna
preciso → preziso
prendido → foke
preparado (estar preparado para algo) → en tempeo
principal → printsiale, primer
privado → privato, privado
probable → probable, probeko
probado → probo
productivo → produktiva
profundo → sundo
prolongado → prolonge
propenso → prono
propio → prope
protegido → protecto
próxima → entera, proxima
público → publiko
pulida → polita
puntuado → puntico
puro → pura
puto → puto
que ha tocado fondo → afonda
que se escapa de las leyes de la geometría euclidiana → paradimensional
rápido → rante
raro → rare, raro
real (de la realeza) → royal
real → real
rechazado → retsaiko
reciente → reciento
recluso → rekluso
recompensado → reguarde
rectal → rectal
redondo → circloko
relajante → relaksanta
relativo → relative
reluciente → enlitaro
remunerado → remoneiata
repentino → repentoso
reservado → reservo
restante → falante, faitante
rico → ritsa
romántico → romantiko
roto → roto
rudo → bardo
ruidoso → noisanta, noisante, audixoso, ruidanta
sabroso → zaproso
saciable → satiable
sagrado → sacro
salado → sialato
salvaje → savaxo
seco → eskarra
secreto → sekreto
seguro → securo
seleccionado → selekteioko
semanal → oleksaia
sencillo → sencille
sentado → siteiko
separado → unyoiko
serio → serio
siguiente → arenko
silencioso → esparoso
silencioso → unoia
simpático → amaiso, simpo
simpático → simaise
simple → simple, sampla 
sin cocinar, crudo (comida) → unkoiko
sin color → kolorfala
sin daño, sin dolor → daxafala
sin duda, indudablemente → dubafala
sin manufacturar, en crudo → unhano
sin sentido → sensofala
sin vida → vitafala
sincero → etristuro, sinzero
soberbio → superbo
sobrevalorado → airvaluako
social → sozial
solo (estar solo) → ekoro
soñador → pentsieko
sonido alto, sonido fuerte → kliza, klizanta
sonido bajo, sonido flojo → unoibla
sordo → sorda, oifala
suave → iabe, lige
sucio → druxo
suficiente → sufizente
supto → supto
sútil → indorafala
sutil → piskizo
tardío → enterino
tecnológica → texnologika
templado → tempero
tenue → sove
termal → termalo
terminado → fino
terminal (estado) → terminal
terrenal → terranal
terrorífico → terruo, teruo
tétrico → auskura
tibio → templa
tierno → aile
típico → tipika, tipikar
trabajador → travaxeko
traicionero → trastoso
tranquilo → einxo, calmo
transcriptiva → transcribiko
transitiva → transitive
trastornante → yigoiko
triste → tristeko
tropical → tropikal
ultimo → elasto
único → uniko
unido → yoiko
uperisado → uperisato
urbano → urbe
usual → usuala
útil → utila
utópico → utopica
vacante → vakante
vacío → vatio
vago → sugarra
válido → valo, valito
valorado → valuako
vasto → vasto
vecinal → neiborako
verdad → verta
verdadero → verdadeko
verificado → verifeko
vertical → vertico
viejo (adjetivo) → igerne, igerno, elde, oko
virtual → virtual
visto → viso
visualmente agradable → fanze