Abril → Aiprila
Afganistán → Afganistan
Afgano → Afgano
Agosto → Agaisto
Albania → Albanea
Albanés → Albanexe
Alemania → Duxlan
Alemán → Duxlano
América → amerika
Andorra → Andorra
Andorrano → Andorreo
Angola → Angola
Angolano → Angolaneo
Antigua y barbuda → antigua e barbuda
Antiguano → Antiguaneo
Antártida → Antartika
Arabia Saudita → Arabika Saudita
Argelia → Argelia
Argelino → Argelineo
Argentina → Argentia
Argentino → Argento
Armenia → Armenia
Armenio → Armeno
Asia → Asia
Barcelona → Barcelona
Berlin → Berline
Brasil → Brazil
Brasileño → Brazilenno
Bucarest → Bukaresti
Bélgica → Belgia
Canadá → Canadia, Kanada
Chile → Tsile
China (país) → Tsina
Chino (gentilicio) → Tsineo
Colombia → Kolombia
Copenague → Kopenage
Cuba → Cuba
Diciembre → Dicembro
Domingo → dominko
Ecuador → Equator
Egipto → Egipto
Enero → Januaro
España → Espanna
Español → Espannol
Esperanto → esperanto
Estados Unidos → Estatioit Yoiko, USA
Estonia → Estonia
Estonio → Estonesa
Europa → europa
Febrero → Febrero
Francia → Francea
Francés → Francesa
Helsinki → Jelsinki
Hindú → Hindu
Holanda → Holande
India → Hindea
Inglaterra → Angloterra
Inglés → Anglo
Italia → Italia
Italiano → Italeano
Japonés → Japonesa
Japón → Japonia
Jueves → traxhia
Julio → Xulio
Junio → Januo
Júpiter → Xeipiter
Lisboa → Lisbona
Londrés → Londonia
Lunes → lunia
Madrid → Madrid
Marte → mairte
Martes → martia
Marzo → marzea
Mayo → Maio
Mexicano → Mexikano
Miércoles → xeitore
Moscú → Mosku
México → Mexiko
Neptuno → neptuno
Noruega → Norkia
Noruego → Norkeo
Noviembre → Novembo
Nueva york → Nevo york
Oceanía → ozeania
Octubre → Octambo
Paraguay → Paraguai
Paris → Parisa
Polaco → Polaka
Polonia → Polakia
Portugal → Portugal
Portugués → Portuguesa
Roma → Roma
Rumano → Romaneo
Rumanía → Romanea
Rusia → Ruzia
Ruso → Ruzeo
Saturno → saturno
Septiembre → Septembro
Sudámerica → suramerika
Suecia → Suekia
Sueco → Sueko
Suiza →  Suxiza
Suizo → Suxizo
Sábado → hixtane
Tallin → Taline
Ucrania → Ukrania
Urano → urano
Uruguay → Uruguai
VIH → VIH
Varsovia → Varsova
Venecia → Veniza
Venezuela → Venezola
Venus → venux
Viernes → vernia
abadía → abia
abandono → ekoretio
abanico →  abaniko, cuenda
abarca → abarka
abastecedor → rekarette
abastecimiento → rekaratio
abastecimiento → rekarotio
abdomen → abdomo
abdominal → abdomonexo
abecedario →  letratablo
abedul → atria
abeja → blaimallea
aberración → aberratio
abertura → aipreixo
abeto → karzua
abismo → abystela
abogado, legista → abvogette
abolladura, abollón → hundo
abono (abonar dinero) → abono
abono (tierra) → tseso
abordaje → aborratio
aborto → aborto
abracadabra → magika ragika
abrazo → hogo
abrebotellas → aiprebotelo
abstención → abstena, astaino
abstinencia → abstena
abuela → meioko
abuelastra → inestmeioko
abuelastro → inestumoko
abuelo (genérico) → oko
abuelo → umoko
abundancia → abontia
aburrimiento → aborraitio
acabado → bertso
acacia → akacea
academia → akademia, academos
acampada → akempa
acapella → acapela
accesibilidad → akcesibila
acceso → akciso
acción rápida → rante aktio
acción → aktio
aceite → asoa
aceitera → asonexo
aceleración → acelereitio
acelerador → aceleoro
acento → acento
acera, pavimento → vadeo, kalekemno
acero → akero, azero, acero
aciano, azulejo (flor) → anilo
acidimetría → acidimetria, acidimetrica
acierto → tro
acogida → akaina
acompañamiento → akompanniretio
acondición → akonditia
acordeón → acordeon
acrobacia → akrobatia
acróbata → akroxette
actinometría → actinometria, actinometrica
activación → aktivatio
actividad → aktivita
acto → akto
actor → actor
actriz → actoras
actuación → aktoatio
actualización → airposo
acuario → acoario
acuerdo → akordo
acumulación → acumo, acuma, acumula, acumulo, cumul, cumulo
acusativo → akusative
adelantamiento → alancara
adelanto → alanco
adenología → adenologia
adicción → adiktia
adición → ado
adivinanza → mendejoko
administrador → administreiette
adobe → adobe
adonis (flor) → adonis
adoración → adoro
adrenalina → adrenalina
aduana → otertseqe
adverbio → adverba
advertencia → varno
aerocriptografía → aerocriptografia, aerocriptografica
aerofotografía → aerofotografia, aerofotografica
aerografía → aerografia, aerografica
aerología → aerologia
aeropuerto → aerporto
aeróbic → aerobika
afección → afektio
afecto → afekto
afeitadora → xaveioro
afeitamiento → xava
aficionado → afizionette, abanere
afición → afizio, aban
afijo → afixe
afilación → alfilatio
afirmación → aiatio
agache → prige
agarre → suje
agencia → agentia
agitación → xata
agonía → agonia
agorafobia → agorafobia
agradecimiento → grazeizero
agrafía → agrafia, agrafica
agresión → agresio
agricultor → agrikulxette
agricultura → agrikultura
agroecología → agroecologia
agrología → agrologia
agrupación → agrupatio
agua con gas → gasacoa
agua → acoa
aguacate → guacafruki, aguaco
aguante → jena
aguijón → estungo
aguja → alfilo
agujero de bala → racobale
agujero → raco
aidanacia → aidanakia
aidanés → aidanesa
aire acondicionado → aerakonditiaoro
aire → aer
ajedrez → jakon
ajo → garlo
ajolote → ajolote
ajuste → rikro
ala → vingo, ala
alarma de incendios → fokalarme
alarma → alarme
albinismo → albinisma
albino → albino
albóndiga → bolkar, bolakar, bolakarno
alce → bazerra
alcohol → etanol, altsol
alcoholimetría → alcoholimetria, alcoholimetrica
alcohometría → alcohometria, alcohometrica
aldea → aldea
aldeano → aldeano
aleatoriedad → rungia
alegría → aibe
alergología → alergologia
alergólogo → alergologo, alergologette
aleta → fina
alfabeto → alfabeto
alfajor → almodratso
alfil (ajedrez) → espare
alfombra → corta
alga → kalpa, alga
algo cuyo valor o cantidad está entre el doble y el triple de otra cosa → superdoble
algo o lugar oscuro y depresivo → auska
algoritmo → algoritmo
alimentación → flomo, nisigo
alimento → flomiga, nisingo
alineación → aliniatio
alita de pollo → acrivingo
alma → anima
almacenaje → esmariun
almacenamiento → esmaretio
almacén → esmareitela
almeja → matsasa
almena → almena
almendra → almondra
almidón → amilone
almohada → bexe
alometría → alometria, alometrica
alpaca → pulca, kiva
alquilado → rentaio
alquiler → renta
alquitrán → betarra
alta mar → intramare
altar → altar
altavoz, parlante → parloro, sonikemitero
alternativa → alternas
alterne → alterne, xia
altimetría → altimetria, altimetrica
altura → aitora
alubia → blon
alucinación → alutination
amanecer → amanza
amanecer → solnata
amanita → amanita
amante → loiere
amapola → maploa
amaranto (color) → amaranto, amaran
amaranto (flor) → amaranto
amargado → tsagrioso
amatista → amatista
ambientólogo → ambientologo, ambientologette
amenaza → zrota
ametralladora → metrallaro
ametría → ametria, ametrica
amianto → mallera
amigo con derecho → rotsenko
amigo, amiga → amike, amiko, amika
amistad → amikia
amonestación, multa → penalite
amor → loi
ampelografía → ampelografia, ampelografica
ampelología → ampelologia
ampersand, y comercial → et-tsara
amputación → amputatio
amputación → unmembria
analogía → analogia
anarquía → anarqia
anatomopatólogo → anatomopatologo, anatomopatologette
anca → anka, anca
ancan → alzamiento
anchura → faldaia
anciano → oko
ancla → ancla
anclaje → anclaxo, fixo, anclo
andador → andaivo
andamio → hatena
andesita → andesita
androide → androido
andrología → andrologia
andrólogo → andrologo, andrologette
andén → vaden
anemografía → anemografia, anemografica
anemometría → anemometria, anemometrica
anestesia → anestesia
anestesiología → anestesiologia
anestesiólogo → anestesiologo, anestesiologette
anfibología → anfibologia
angelología → angelologia
angila → gistomo
angiografía → angiografia, angiografica
angiología → angiologia
angiólogo → angiologo, angiologette
anguila → zegor, zangela
anillo → rinka
animal → animal, besta
aniversario → yaroia
anochecer → nitoia
anomalía → anomalia
antibiótico → antibiotiko
antifaz → antifaz
antiguedad → antiaga
antilogía → antilogia
antimateria → antimateria
antología → antologia
antorcha → tortsa
antro → antro, crumbo
antropografía → antropografia, antropografica
antropología → antropologia
antropometría → antropometria, antropometrica
antropólogo → antropologo, antropologette
antólogo → antologo, antologette
antónimo → antonimo
anuario → yarizboto
anuncio → adva
análogo → analogo
anémona (flor) → anomas
apagamiento → ofetio
apagón → deof, grata unlita
aparición → aparezeitio
apeadero → apeadela
apellido → aurnome, ginome
apertura → aipreio
apicultor → apikulxette
apicultura → apikultura
apifobia → apifobia
aplauso → klapa
aplicación → aplikatio
apodo → xenome
apología → apologia
apoyo (ayuda o protección) → elade
apoyo (cargar; hacer descansar) → ersoro
apoyo (respaldar; aprobar) → proa
aprendizaje → aprendeixo
aprobación → aprovatio
aprobado → aprovo
apuesta → posta, beta
apuñalada, puñalada → estava
apuñalamiento → estavo
apólogo → apologo, apologette
aracnofobia → araknofobia
aracnología → aracnologia
aracnólogo → aracnologo, aracnologette
araña → vesuka, aracna
arboleda → arbotsiun
arbusto rodante → erbusto da deserto
arbusto → erbusto
arce → gizalda
archipiélago → artsipelago
archivo → file
archivología → artsivologia
archivólogo → artsivologo, artsivologette
arcilla → clugra
arco → arketo
arcoiris → kolorarico
ardilla → esquiro, bunyo
area → area
arena → auxa
arenas movedizas → auxarran
arenisca → limarro
aretalogía → aretalogia
arma → arma
armada → armatia
armadillo → puntsirra, armado
armadura → armatsosto
armario → orraqe
armiño → mantra
arqueologo → arqeologe
arqueología → arqeologia
arqueozoología → arqeozoologia
arquero → arkerette, arkero
arqueólogo → arqeologo, arqeologette
arranque → arrantsa
arreglo → reparo
arrepentimiento → repentia
arrocera → razoro
arroz → raz
arte → arte
artefacto → artefactum, artefacto
arteria → arteria, atokla
arterial urbano, carretera de muchas vías que conecta una ciudad con la autopista → viato, viaton
arteriografía → arteriografia, arteriografica
arteriología → arteriologia
artesano → artisette
artista → artista, artisette
artrografía → artrografia, artrografica
artrología → artrologia
artículo básico para vivir → viver
artículo → articulo, articlo
arvicolino → arvicolino, arvicolo
arándano → aniluba
as (cartas) → as
ascenso → ansenno
ascensor → airoro
asedio → sieva
asesinato → asesanato
asesino → asesain
asiento → asenda
asimetría → asimetria, asimetrica
asiriología → asiriologia
asiriólogo → asiriologo, asiriologette
asno → ostoro
asociación → asociatio
aspecto → aspectia
aspiración → aspira
aspiradora → aspiraoro, droupingoro
aspirina → anfluga
asta → bertsa
astato → astato
asteroide → astre
astil → bertsilo, manga
astilla → artsa
astro → astro
astrobiología → astrobiologia
astrografía → astrografia, astrografica
astrología → astrologia
astronauta → astronatte
astronomía → astronomia
astrólogo → astrologo, astrologette
astrónomo → astronomo, astronomette
asunto → reaso
atajo → arcuto
ataque al corazón → koraisagra
ataque → atakte, atake
atardecer → tarena
atasco (generico) → estora
atasco (tráfico) → via estora, ambotela
atención → atentio
atleta → atlette
atletismo → atletisma, atletismo
atril → lekteoro
atrio → atrio
aturdimiento → xako
atún → tunna
audio → audeo
audiología → audiologia
audiometría → audiometria, audiometrica
audiólogo → audiologo, audiologette
audífono → audefono
aullido → ulule, ulula
aumento → easa
aura → auram
auricular → oitosono
aurora → aurora
australia → australia
australiano → australiano
austria → austria
austriaco → austrio
autismo → autisma
autobiografía → autobiografia, autobiografica
autobús → autobus
autofobia → autofobia
autografía → autografia, autografica
autopista → rakemnalea, via rante, viarante, rantevia
autor → autora
autólogo → autologo, autologette
avance → entero
avaricia → avaritia
avenida → avenua
aventura → ventura
aventurero → venturette
avestruz → otsorra
aviso → avisto
avión → avionno
axiología → axiologia
axonometría → axonometria, axonometrica
ayuda → lade
azada → labraioro
azafrán (flor) → aziala
azahar (flor) → azaharo
azar → runge
azul celeste → acoa
azul cobalto (color) → cobalta, cobalda 
azulejo (pájaro) → eskala
azúcar → sukra, sucra
añalejo → relicrolista
año → yaro, anio
baba → clia
bacalao → terrapesko
bacon, tocino → bacon
bacteriología → bacteriologia
bacteriólogo → bacteriologo, bacteriologette
badén → batino
bahía → baheia, bahia
baile, danza → danze
bajada → aura
bala → bale
balance → balanze
balanza → balante
balcón → evokinda
balda → escola
balde → vanokisa, ropakisa
ballena → argeya, baola
baloncesto → bolacesta
bambú → bambo
banco (edificio) → banko
banco (sentarse) → sendaia
banda → banda
bandeja → indaksa
bandera aidanesa → patriska
bandera → fliaga
banquero → bankexette
banquete → banqete
bar → bar
baraja → baraja
barba → berdo
barbacoa → barbaqeu
barco → barco
barra → cana, baferro, barre
barras (parque) → moncanit
barrendero → furrette
barrera → barrera
barricada → barraca
barrido → furre
barril → barrila, tondra
barrote → furne
barón → baron
basalto → basalto
base → base
bastilla → bastila
bastión → baluaro, bastira
bastón → baton
basura → grax
batalla → bataila
bate → bate
bateador → batero
batería (instrumento) → bateria
batería, pila (energía) → plika
batido → socrema
batidora → socremoro
batimetría → batimetria, batimetrica
batología → batologia
bauxita → bauksit
baya → eruba, baia
bazar → bazar, baziar
bazooka → bazuka
bañera → bax
baño (lugar) → mertaitela
baño (referencia a objeto) → mertaioro
bebida → acoixo
bebé → beko
bechamel → betsamel
begonia (flor) → begonna
belleza → belesa
bellota → nutsa
bendición → bendizatio
beneficio → benefitio
bengala → bengala, fira
berenjena → isaloa
berlina → berlina
berza → tola
beso → beso
bestia → besta
bibliografía → bibliografia, bibliografica
bibliología → bibliologia
biblioteca → bibloteka
bibliotecología → bibliotecologia
bibliotecólogo → bibliotecologo, bibliotecologette
bicho → tiko
bicicleta → birroda
bigote → mitso, furmo, moustatso, mustatso, vigo
bilingüe → bilingo
binocular → binocular
biobibliografía → biobibliografia, biobibliografica
bioestratigrafía → bioestratigrafia, bioestratigrafica
biogeografía → biogeografia, biogeografica
biografía → biografia, biografica
biología → biologia
bioma → bioma
biometría → biometria, biometrica
biosociología → biosociologia
biotecnología → biotecnologia
biotecnólogo → biotecnologo, biotecnologette
biotipología → biotipologia
bisabuela → bismeioko
bisabuelo → bisumoko
bisagra → izoya
bisagra, pernio → torqe
bisexual → bisexualo
bisexualidad → bisexualita
bismuto → bismuto
bisonte → bisonte
bit → bit, bito
biólogo → biologo, biologette
bloque → bloke
bloqueo → lokeo
boa → zisga
bobsleigh → bobsleigh
boca → opa, oupa
bocadillo → britango
bodega → vinotela, celara, birratela
bola de nieve → aigebola
boleto → fixola
boletus → boletus, mastufa
bollería → bunaria
bollo → bollo, bun
bolsa → baga
bolsillo → pokete
bolso → poketo
bolígrafo → tentaoro, boli, pen
bomba → bomba
bombardero → bombardoro
bombero → ignoextingette
bombilla → bulba
bombona → butanna
bombón → tsoklo
bondad → bainata
bongo → bongo
boquilla → oupila
borde, lateral (geometría) → asero
borrador (boceto) → druxeto
borrador (herramienta) → prusaioro 
bosque → fisi, arbotsiun
bota → bota
bote → bote
botella → botelo
botón de enter → intro, intro botonna, enter, enter botonna
botón de retroceso → retro, retro botonna
botón de suprimir → prusai, prusai botonna
botón → botonna
branquia → brankia
braquigrafía → braqigrafia, braqigrafica
braquilogía → braqilogia
brazalete → airoie
brazo → airo
bricolaje → bricolagia
brillo → brio
brisa → briza
brizna → hebra
broche → brutsio
brocheta → brotsete
broma → rusa
bromatología → bromatologia
bromatólogo → bromatologo, bromatologette
bromelia (flor) → estarola
bromo → bromo
bronce → bronce
brote de árbol → brairo
bruja → vitsa
brujería → vitsia
brío, garbo → farla
brújula → redanorto
bucle → loop
budismo → budisma
buey → zarra
bufanda → bunfaza
bufón → bulanere, xiabette
buitre → xikorra, vorle
buque → buqe, dunko
burca → burca, burka
burgo → burge
burla → bula, vanka
burrito → burrito, kubrutso
burro → zigar
buscador (cosa) → findaoro
buscador (persona) → findette
buscador → trovarette
busto → perpetro
butaca → cansenda
butano → butano
bárbaro → barbaro
bégimo → behemuto, bemoz
béisbol → beisbola
búfalo → bufalo
búho → ebande
búsqueda → findo
caballero (hombre) → vero
caballero (que monta a caballo) → ayette
caballería → veria, cavalria
caballito de mar → marayato
caballo (ajedrez) → ayette
caballo (animal) → ayato
cabecera (texto) → andesora, prescritum
cabeza (cuerpo) → antsasa, casca
cabina → cabin
cable → guiro, tokla
cabra → koato, gate, visco
cabrón → morogo
caca → kaka, nnordo, fecta
cacahuete, cacahuate → cacauato
cacao → cacao
cacerola → kaserola
cacería → junziasa
cacografía → cacografia, cacografica
cacología → cacologia
cactus → cactia
cada → kada
cadena → tsaden
cafetera → kafetoro
cafetería → kafetela, café, cafeteria, kafeteria
café → kafe
cagada → mertato
caida → arga
caja de herramientas → horocuba
caja fuerte → herrocuba
caja → cuba
cala (flor) → belania
calabacín → cumba
calabaza → pumka, fai, fain
calamar → kalatrono, kalamo
calamidad → calamitas
calavera → antsoarko
calcetín → poitexo, calzo, calza
calcografía → calcografia, calcografica
calculadora → kalculoro
caldera, calentador → caldron
calefacción, calefactor → kaleria 
calendario → henlista, calendaro, calendario
calentamiento → kaleirisa
caligrafía → caligrafia, caligrafica
calle (referencia general) → estrato
calle (unidad) → kale
callejero → estratoge
calografía → calografia, calografica
calología → calologia
calor → kaler
calorimetría → calorimetria, calorimetrica
calzoncillo → carkazono, hunga
caléndula → calendula
cama → dormebas
camaleón → jideor
camarero → hostexette
cambio → kambio
camello → usatsa, camolo
caminante → kemnette
caminata, andanza → andaia
camino → kemno, rata
camisa → kamisa
camiseta → kamiseta
camisón → camiso
camión → oxtokotse, lorro
campamento → akempo
campanero → campelette
campanología → campanologia
campanólogo → campanologo, campanologette
campañol → arvino
campeonato → tsampeonato
campesino → campesette
campeón → tsampeon
campimetría → campimetria, campimetrica
campo de arroz → razna
campo de cultivo, cosechas → azna
campo → kempo
canal → kanala
cancelación → kanzelatio
cancerología → cancerologia
cancerólogo → cancerologo, cancerologette
cancha → kempo, jokotela
canción → qanzio
candelabro → candalabro
candelabro → candeloro
cangrejo → kraba
canguro → kangoro
canibalismo → canibalisma
canoa → canoia
cansancio →  infize
cantautor → qanzautora
cantera → petrotela
cantero → petroxette
cantico → qanzigo
cantidad → qantita
cantimplora → acoino, cantimpla
cantina → cantena, ingotela
canto angeligcal → ancanto
canto → qanzo
caníbal → canibal
caoba → untsua
caos → tsaos, caos
capa → elara
capacidad de algo para mantenerse íntegro; consistente y no dañarse o degradarse con el tiempo → atomicita
capilla → capela
capital (ciudad) → enciuta
capital (dinero) → capital
capitalismo → capitalisma
capitán → captanna
captura → kapta
capullo (mariposa) → cucula
capullo → fasoa
cara → fazia
carabela → carabela
caracol → itsa, cargo
caracterología → caracterologia
caracterólogo → caracterologo, caracterologette
carburante → carburanto
carburo → carburo
carbón vegetal → madrakarbona
carbón → karbona, cocola
carcaj → qiava
carcinología → carcinologia
cardiografía → cardiografia, cardiografica
cardiología → cardiologia
cardiólogo → cardiologo, cardiologette
cardo → tsardo
carga → karga
cargador → kargaoro
caricia → carica
carisma → tsarisma
carnaval → carnavala
carne de cerdo → porketa
carne → karno
carnet de conducir → carne da drivai
carnicero → karnirette
carpeta → folda
carpintero → madraxette
carpología → carpologia
carrera (juego) → zurraion
carrera (universidad) → cursogra
carretera → rakemno
carruaje → azurreje
carrusel → carrusel
carta (texto) → letera
carta comodín, carta que vale como cualquier otra (juegos) → bianco carde, biancocarde 
carta más alta (mano de póker) → carde aito
cartel antiguo que indicaba a la gente que no portaba una brújula donde está el norte sur este y oeste → letoire, oireleto
cartel → leto
cartero → leteraette
cartilla → cartila
cartografía → cartografia, cartografica
cartometría → cartometria, cartometrica
cartulina → cartula
cartógrafo → cartografette
cartón → cardo
carácter (símbolo) → tsara
casa → kasa, domo
cascada → moana
casco → antsal
caseta, cabaña → asunna, kasutsa
casilla → kasiya
casino → casino
caso → caso
casta → casta
castaña → nizaga
castaño → nizagal
castigo → jusa
castillo → castil
castor → biatse
catalejo → foreviso, forevo
catapulta → zroioro, zroipetre, catapulta
catarsis → katarsis
catastrofe → combe
catenaria → hatena
catálogo → catalogo, catalogette
cauce → calikso
caucho → ruba
causa → causa
cautividad → kautivita
caverna → ergote
caviar → haviar
caza → junze
cazador → junzette
cazo → xikara
cazuela → xikere
caída → argo
caña de pescar → peskanna
caña → kanna
cañón → cannon
cd → cd
cebo, carnada → carro
cebolla → onnete
cebolleta → keleta
cebolleta → setso
cebra → zebra
cecografía → cecografia, cecografica
cedro → citrua
celda → celar
celo → zelo
celíaco → celiaco
cementerio → mortotela
cena → hinge, yantaro
cencerro → beletro
cencerro, campana → campela
ceniza → axa, inzo
censura y eliminación de una persona → aperso
centaurea (flor) → centara
centella (chispa) → tai
centella → centela
centenario → ozenore
centeno → surtso
centrifugadora → zentrifugaioro
centro → zentro
cepillo de dientes → dentabrutsa
cepillo → sebrutsa
cera → equa
cerda (pelo) → furro
cerdo → porko, pigo
cereal → zereal
cerebro  → mentio
cereza → roxuba
cero → zuro
cerradura → klavika
cerrajero → klavikette
cerrojo → kerranda
certificado → certifitio
cerveza → birraza
cesta → cesta
cetro → esceptor, cetro, zetro
cetáceo → cetacio
chaleco → tselo
chamarra → burtso
chaqueta → giaqeta
charco → zanga, culda
charrán, estérnido → terno
chat → chat
chelo → tselo
chica con derecho → rotsenmeia
chica → meia
chicle → tsiklo, goma
chico con derecho → rotsenhone
chico → hone
chimenea → tsimeneia
chimichanga → tsimitsanga
chimpancé → itsimp
chincheta → pinna
chinchilla → tsintsila
chip → chip
chismografía → tsismografia, tsismografica
chispa → kispa
chiste → zizga, tsaska
chistera (sombrero de copa) → tsistera
chocolate → xouclate
chocolatero → xouclatette
chocolatería → xouclatela
choque → bumpo
chorizo → tsurra
chuche, caramelo → dultsina
chupada → lika
ciberfobia → ciberfobia
ciclismo → ciklisma
ciclo → ciklo
cielo (religión) → estelegas
cielo → kailo
cien → ozen
ciencia ficción → cienfiktio
ciencia → cientsa
cienciología → cientsologia
cienciólogo → cienciologo, cienciologette
científico → cientsette
ciervo → perlo, deino
cierzo → qualda
cifra → cifra
cifrado → cifrato
cigarro, cigarrillo → zigarro, cigarro, inzono
cigüeña → suanda 
cilindro → cilindro
cima → zima
cimitarra → escimitarra
cinco → qinco
cincografía → cincografia, cincografica
cine (genérico) → zine
cine (lugar) → zinetela, filmotela
cinematografía → cinematografia, cinematografica
cinología → cinologia
cinta adhesiva (pegar objetos) → amerizinto, anazinto, dukte, zelo
cinta métrica → metrizinto
cinta transportadora → aconveioro
cinturón de asteroides → astrezinto
cinturón de seguridad → securzinto
cinturón → zinto
circo → circo, circus, xiatela
circuito (eléctrico) → circuito, tsiclo
circuito, pista (carreras) → circuito, traka
circunstancia → zirkuntantia
ciruela → pluma
cisne → aista
cisterna → cesterna
cita, reunión → rendevou, rendezvous
citología → citologia
citólogo → citologo, citologette
ciudad → ciuta, ciutatela
ciudadano → ciutatano
ciudadela → ciutatela
claridad → klaritatio
clase → klase
clasificación → clasifike
claustrofobia → claustrofobia
clave → klave
clavel → maira
clavija → klaviya
clavo → klaga
clemátide (flor) → espirita
clic → klika
cliente → komprairette
clima → climaia
climatología → climatologia
climatólogo → climatologo, climatologette
clip → clip
cloro → cloro
cloroformo → cloroforme
coartada → quartada
cobalto (mineral) → cobaldo, cobalto
cobra (animal) → cobra
cobre → copar, ikroso
cocaína → cocaina
cocaína → kokaine
coche, carro, auto, automóvil → kotse, vehiklo, automovo, zurro
cocido → kozido
cocina (lugar de cocinar) → koxineitela
cocina (termino general) → koxina
cocinero → koxinette
coco → coco
cocodrilo → crocus
cocotología → cocotologia
codicología → codicologia
codorniz → cortso
cofre, baúl → gaizecuba
cogida → kaina
cohete → fokonave
cojín → zobexe
cojón (coloquial) → bola, ova, ovo
col → colta
cola (animal) → urda
cola (personas) → qeola
colador → coladoro
colapso → colapso
colcha → laireta
colección → colectia
colegio, escuela → esaroriun, eskola, esaroitela
colibrí → liarta
colina → yordea, sugal
colmena → bajiba
colocación → kolokatio
colonia (territorio) → colonia
colonia, perfume → dafuma
colonización → colonicea
colono → colone
color (mano de póker) → kolor
color → kolor, kromato
colorimetría → colorimetria, colorimetrica
coma (salud) → coma, vegeto estatia
coma (texto) → coma
comadreja → carriya
comando → comando
comba → pulanda
combate (concepto general) → belan, combat
combinación → combo
combustible → nitor, combustable
combustión → combustio
combusto → combusto
comedia → comedia
comediante → comediante
comedor → ingotela
comer (coloquial) → ingoi
comercio → komerzio
comida (genérico), gastronomía típica → ingoria
comida → ingo
comodidad → conforta
comparación → asletio
compartimentalización → kompartilazetio
compasión → compasion
compañero de clase → klasenko
compañero de cuarto → itelenko
compañero de cárcel → cartselenko
compañero de piso → blokenko
compañero → kompannette, enko
compañía → kompania
compendio → compentio
compensación → unlana, compenso
complejo (instalaciones) → komplexo
complemento → komplimento
complexión → komplexio
comportamiento → unba
compra → kompra, loge
comprador → kompraixette
comprensión → comprendo
comprobación → tseqe
comunicología → comunicologia
comunicólogo → comunicologo, comunicologette
comunidad → comunitatia
comunismo → comunisma
concepción → conceptio
concepción → conceptio, conceptia
concepto → concepto
concha → akontse
concierto (musical) → conzerto
condado → contia
conde → condo
condena → condena
condición → konditia
condrografía → condrografia, condrografica
condrología → condrologia
conducto → driveno, condukto
conductor (objeto) → conduktoro
conductor (vehículo) → drivette, conduktette
condón → kundonna
conejo → cono, isgaro, buno, danki
conexión → conektio
confianza → dibla
configuración → configo
confusión → confuzio
congelador → gelaioro
conjugación → conjugatia
conjunto de factores; hechos o caracteristicas de un elemento que se repiten a lo largo de un conjunto → conceptia
conjunto o colección de herramientas → horia, ferramenteria
cono → cone
conocimiento → aonatia, hipe
conquiliología → conqiliologia
conquiliólogo → conqiliologo, conqiliologette
conquista → conqitia, conqista
conquistador → conqeror
consecuencia → qansequentia
conservación → conservatio
conservador → conservette
consola → consola
consorcio → consortso
consorte, cónyuge → conyuge
constelación → constelatio
construcción → tenda
constructor, arquitecto → tendaxette
consumible → consumable
contacto → contacto
contactología → contactologia
contactólogo → contactologo, contactologette
contador → kontoro
contagio → contepia
contaminación, polución → drigatio, polutio
contención → containio
contenido → contento
conteo → konto
contexto → conteksto
continuidad → continuita
continuo → continum
contraseña → codivorto
contraste (color) → contraste
contribución → contribe
control → control
controlador (informática) → controlatoro, driver
conversación → pairetio
conversión → konversio
coordenada → coordenata
copa → cope
copia de seguridad → regaizo
copia → kopea
copo → cope
coprología → coprologia
coque → coke
coral → arima
coraza → koraza
corazones (palo de póker) → koraiso
corazón → koraiso
corbata → corveta
corcho (material) → arkutsa, korko
corcho (panel de corcho) → arkutsaplane
corcho (tapón de botella) → arkutsa
cordero → temo
cordura → concordia
cordón → cordo
coreografía → coreografia, coreografica
coro → coro
corografía → corografia, corografica
corona → korona
corpa → corpe
correcaminos → rantande
corredor → zurrette
correo → maila
correturnos → laborersette, ensekunde
corrida (cualquier significado no sexual) → zurrata
corrosión → corroiso
corrupción → korruptio
cortador → kutoro
corte → kuta
corteza → crusta
cortina de teatro → cortin
cortina → kurtina
cosa → koixa
coscorro (pan) → apatsa, apa, britango
cosecha → cropo
coseno → cosino, coseno
cosmetología → cosmetologia
cosmetólogo → cosmetologo, cosmetologette
cosmografía → cosmografia, cosmografica
cosmología → cosmologia
cosmólogo → cosmologo, cosmologette
cosplay → cosplay
cosquilla → rakia, tiko, tikle
costa → koasta
costilla → crustela
costo, coste → koste
costra → ruxga
costumbre → costume
costura → ehelo
cota de malla → kota, tsadenkota
coyote → cuxate
coño → cunno, vulve
craneología → craneologia
creación → creata
crecimiento → egra
creencia → belei
crema → crema
crematorio → tsizirreitela
crepúsculo → horcasto
cretino → filastra
cria → kraia
criada → kraiette
crimen → crimen
criminal → crimenette
criminología → criminologia
criminólogo → criminologo, criminologette
criobiología → criobiologia
criptografía → criptografia, criptografica
criptología → criptologia
crisantemo → crisantemo
crisol → crucibla
cristal (mineral) → kristal
cristal (vidrio) → klisal, vitro
cristalero → klisalaqe, vitreqe
cristalería → klisalatia
cristalografía → cristalografia, cristalografica
cristianismo → kristianisma
cristología → cristologia
criteriología → criteriologia
cromatografía → cromatografia, cromatografica
cromolitografía → cromolitografia, cromolitografica
cromotipografía → cromotipografia, cromotipografica
cronobiología → cronobiologia
cronografía → cronografia, cronografica
cronología → cronologia
cronometría → cronometria, cronometrica
cronólogo → cronologo, cronologette
cronómetro → klokometera
cruasán → croasan
cruce → crosa
crucificción → crosafiktio 
crujido → cruste
cruz → crosa
cráneo → craneo
cráter → crater
crédito (de crear algo) → credito
críptido → criptide
crónica → cronike
cuadrado → qatrato
cuadro → kadro
cuadruplex → quadruplex
cuadrícula → qatratiko, griya
cuartel → quartel
cuarteto → qarteto
cuarto (habitación) → itela
cuarto (tiempo o matemáticas) → quarto
cuatriciclo → quatroda
cuatrilingüe → qatrilingo
cuatro → catro
cubo → kubo
cubrimiento → kubraia
cucaracha → mustanekro, mikoro
cuchara → cuela, boutsara
cuchillo → akuttere, nivo
cuello de botella → otsotino
cuello → corlo, pisotsa, otso
cuenco, bol → kisa
cuenta (números) → konta 
cuenta → akanta
cuento, fábula → fabla
cuerda → resta
cuerno → corno
cuerpo → corpo
cuervo → corvo
cuestión → kuastion
cueva → encova, erga
cuidado → culda
culo → cule, bango, botso, anusa
culpa → riaxa
cultivo → kultivo
culto → culto
cultura → kultura, viri
cumbre → cumbra
cumpleaños → henyaro, natahen
cupón → bone
cura (antídoto) → kura
cura, sacerdote → praisoxette
curiosidad → kurioseata
curling → curling
curruca → surle
currículum → curriculum, curriculo
curso → curso
cursor → cursor
curva → vira
cuártel → iritela
cuásar → quasar
cuña → cunna
cámara (genérico) → camera
cámara (sala o habitación) → tsambora
cámara de fotos → fotocamera
cámara de vídeo → vidiocamera
cámara frigorífica → gelocamera
cáncer → cancer
cápsula → capsula
cápsula → kapsula
cárcel → cartsela, prison
cáscara (platano) → muzka
cátodo → catodo
célula → celula
césped → briaxa
círculo → radion, circlo
cóctel → coktel
códex → codex
código postal → postalcodiko, postalcoda
código → codiko
cólera → xolera
cómic, tebeo → comic
cúrcuma → cucumo
dacriología → dacriologia
dactiliología → dactiliologia
dactilografía → dactilografia, dactilografica
dactilología → dactilologia
dado → aleo, dize
daga → diaga
dama → dama, mena
damas (juego de mesa) → menale
dato → data
daño → daxa
deber (algo que debes) → dute
deber (colegio) → esaroidute
decapitación → dantsa, fasco
decapitador → dantsette, fasqette
decatlon → decatlon
decimal → decimal
decisión → deze
decoración → vanaizo, vanairo
decágono → decakono
decálogo → decalogo, decalogette
dedal → fakro gid
dedo → gid
defecto → defekto
defensa → defenda
defensor → defendette
deficiencia → defizientia
definición → definitio
deidad → deida
delfín → delfino
delicia → deliko
democracia → democratia
demografía → demografia, demografica
demonio → damon, daemon
demonología → demonologia
demonólogo → demonologo, demonologette
dendrografía → dendrografia, dendrografica
dendrología → dendrologia
dendrólogo → dendrologo, dendrologette
densimetría → densimetria, densimetrica
densitometría → densitometria, densitometrica
dentadura → dentatia
dentista → dentaxette
dentríficio, pasta dental → dentacrema
deontología → deontologia
dependencia → dependentia
deporte → esporte
deportista → esportette
depresión (montañas) → depresion
depresión (sentimientos) → depresia, depreia
depuración → puratio
derecha → dereite
derecho (ley) → dereita
dermatología → dermatologia
dermatólogo → dermatologo, dermatologette
derrame → derrame
derrota → derroqe
desactivación → deaktivatio
desagrupación → unagrupatio
desaparición → unparezeitio
desaprobación → deaprovatio
desarrollo → deurrayo
desastre → disastra
desatascador → unastainoro, unastaino, unestoro
desayuno → primer
desbloqueo → unlokeo
descanso → hixe
descarte → descarda
descenso → densenno
descripción → deskriptio
descubrimiento → aonato, aonatia
descuento → aurventa
desecho, basura → desexo, zorro
desembarco → desbarco
desembocadura (río) → rioke
desengrasador → torqette
desengrasante → torqera
deseo → dezo, pregardo, agux
desfile → deslina
desierto → deserto
deslizador → esleiner
deslizamiento → esleia
desmayo → dizkoia
desnudo → abiare
despensa → celara
desprendimiento → bocar
destello → destelo
destino → desteno
destornillador → desexkraboro
destrucción → distro
destructor → distroro, distructor
desvario → desvario
detalle → detaila
detergente → detergo
determinación → determinatia
deuda → dutia
deudor → dutor
diabetología → diabetologia
diabetólogo → diabetologo, diabetologette
diablo de tasmania → tasmania-devila
diablo → devila
diagnóstico → diagnostiko
diagrama → deagrama
dialectología → dialectologia
dialectólogo → dialectologo, dialectologette
diamante → diamento
diamantes (palo de póker) → diamento
diana → nesiga
diario → hengia
diarrea → afluga
dibujante → dixette
dibujo → dixo
diccionario → diktionario
dicho → dikero
dictador → dictatoro
dictadura → dictatura
diente de león (flor) → sedara
diente → denta
dieta → dieta
diez → dez
dificultad → derrenno
digito → digito
dilatometría → dilatometria, dilatometrica
dilogía → dilogia
dimensión → dimensia
dinamita → dinamita
dinamometría → dinamometria, dinamometrica
dinero, pasta → moneta
dinosaurio → dinosauro
diorita → diorita
dios → deis
diosa → deisa
diploma → diploma
diplomático → diplomaxette
diptografía → diptografia, diptografica
dirección (hacia algo) → dirija
dirección (lugar) → direktia
directiva → directiva
director → dirijette
disciplina, doctrina → discipula
disco duro → esmarediske
disco → diske
discografía → discografia, discografica
discordia → diskordia
discoteca → discotela, discoteka, disco
discriminación → discrima
discípulo → disciplo
disfraz → desfro, vanga
disgrafía → disgrafia, disgrafica
disimetría → disimetria, disimetrica
disparo → desparo
disponibilidad → disva
disposición → disposa
dispositivo → alitaro
disquete → diskete
disrupción → disrupta
disruptor → disruptor
distancia → longara
distopía → distopia
distrito → distrikto
diversión → xiaibela
divisa → divisa
división → diproxo
divisor → dipre
diálogo → dialogo
doble pareja (mano de póker) → doble paren
doble → doble
doctor → doktor
documento → dokumento
dodo → dodo
dogma → dogma
dolor → dole
dominada (ejercicio) → domonija 
dominio → dominio, domo
donación → dona
dormitorio → dormeiun
dos → dois
dosimetría → dosimetria, dosimetrica
doxografía → doksografia, doksografica
doxología → doksologia
dragón → dracono
droga →  drojo, drogo
dromedario → dorgo
ducha → tsoaga
duda → duba
duelo → duelo
dueño, dueña → donno
duo → duo
duplografía → duplografia, duplografica
duración → dula
dvd → dividi, devede, dvd
dársena → portakarga
décima → decima
día festivo, festivo → ferehen
día → hen
días de vacaciones → ferehenit
dólar → dolar
dúplex → duplex
ebullición, evaporación → inherba
eco → eco
ecocardiografía → ecocardiografia, ecocardiografica
ecografía → ecografia, ecografica
ecología → ecologia
econometría → econometria, econometrica
economía → economia
ecotoxicología → ecotoksicologia
ectoplasma → ectoplasma
ecólogo → ecologo, ecologette
edad (tiempo de existencia) → yaria
edafología → edafologia
edafólogo → edafologo, edafologette
edición → editio
edificio → tendo
editor (persona) → editette
editor (programa u objeto) → editoro
efecto → efekto
eficiencia → efizientia
egiptología → egiptologia
egiptólogo → egiptologo, egiptologette
ejemplo → exemplo
ejercicio → exersizo
el acto o la obra por el intento de terminar con una entidad fisica o abstracta → ultimatum
el hecho de apagar algo → unlita
el hecho de darse cuenta de algo → indora
el hecho de encender algo → lita
elección →  electio
electricidad → elektritia
electrocardiografía → electrocardiografia, electrocardiografica
electroencefalografía → electroencefalografia, electroencefalografica
electrofisiología → electrofisiologia
electrometría → electrometria, electrometrica
electrón → elektronno, electron
elefante → estsondo
embarcadero → embarcatero
embarco → embarco
embriología → embriologia
embriólogo → embriologo, embriologette
embudo, tolva, cuello de botella → buva
emergenciólogo → emergenciologo, emergenciologette
emisor → emitero
emoción (emocionar) → emozio
emoción (sentimiento) → emotia
emoji, emoticono → emoji
empalme → apalme
empanada → ebritaita
empanadilla → ebritaitita
empanado → ebrito
empatía → maiso
emperador → emperos
emperatriz → emperas
empotración → empotratio
emprendedor → entreprenor
empresa → enterprisa, kompania
empuje → puja
encanto → enxanto, encanto
encefalografía → encefalografia, encefalografica
enchufe, tomacorriente → pluga
enciclopedia → enciklopedia
enclave → entsave
encuesta → contesta
endemia → endemos
endocrinología → endocrinologia
endocrinólogo → endocrinologo, endocrinologette
enemigo → enemike, enemika, enemiko
energía → eneryia
enfado → rutsu
enfermedad → ebila
enfermero → ebilaxette
enfermería → ebilatela
enfoque → foca
enfriamiento → aigeisa
engaño → lerra
engranaje → giar
enjuague → yogo
enlace → linke
enología → enologia
enrutador → enrotare
ensalada → ensalada
entendimiento → enderia
entidad → entita
entierro vivo → vitauro
entierro → enterro, auro
entomología → entomologia
entomólogo → entomologo, entomologette
entrada → entratela
entropía → entropia
envío → dario
enzima → enzima
enzimología → enzimologia
enólogo → enologo, enologette
eperlano, capellán → zancobo
epidemia → epidemos
epidemiología → epidemiologia
epidemiólogo → epidemiologo, epidemiologette
epigrafía → epigrafia, epigrafica
epistemología → epistemologia
epistemólogo → epistemologo, epistemologette
epizootiología → epizootiologia
epílogo → epilogo, epilogette
equipo → eqipo
equivalente a 1 millón de muertes → megamorto
equivalente → eqivala
era → era
ergología → ergologia
ergometría → ergometria, ergometrica
ergonomía → ergonomia
erizo → jedogo, pinkiporke, pritso
ermitaño → eremita
erosión → erodia
erotología → erotologia
erotólogo → erotologo, erotologette
error, fallo, errata → erra, mistaco, faio
escala → eskala
escalera (mano de póker) → linia
escalera de color (mano de póker) → kolorlinia
escalera → escalatorra
escama → eskama
escaparate → dorimo
escarabajo → karabajo
escatología → escatologia
escena → estena
escenografía → escenografia, escenografica
esclavo → eslavo
escoba → furra, droupeta
escobilla → furrisa
escolta → eskolta
escopeta → busterre
escopetazo → buste
escorpión → escorpio
escozor → eskozo
escrito → sore, izkriba
escritorio (mueble) → izkretela, izkrotela
escritorio (ordenador) → desto, desktop
escritura → soratia, izkribatia
escroto → escroto
escuadra → escuadra
escuadrón → escuadra
escudo → seldo
escurrida → guta
escurridor → gutaoro
escándalo → estantsa
esencia → esentia
esfuerzo excesivo → reveuyerance
esfuerzo → veuye
eslavo → eslava
esmalte → esmaro
esmegma → esmegma
esmeralda → emeralda
esoterismo → esoterisma
esotérico → esoterico
espacio en blanco → biancara
espacio libre, espacio vacío → librespatio
espacio → espatio
espada → raiyoa, suarda
espadaña → dragonkane
espagueti → espageti
espalda → betranno
espantapájaros → escorraco
espanto → escorro
esparto → esparto
especialidad → espezialitata
especialista → espezialista
especie → espezie
espectador → espekteixette
espectro → espector
espectrofotometría → espectrofotometria, espectrofotometrica
espectrografía → espectrografia, espectrografica, espectorografia, espectorografica
espectrometría → espectrometria, espectrometrica, espectorometria, espectorometrica
espectáculo → espectaclo
espejo → espelekto
espeleología → espelologia
espeleólogo → espeleologo, espeleologette
espera → herre
esperantista → esperantesta
esperanza → aikala
espermatozoide → bianguro
espesura → hexegia
espina → tira
espirometría → espirometria, espirometrica
esposa → meixa, meila
espuma → hixa, fomo
espátula (animal) → platintso
espátula (herramienta) → esplata
espíritu → espirita
esquema → eskeme
esquina → eskina
esquinazo → eskinata
esquive → inze
establecimiento → establezimento
establo → ayatotela
estación (del año) → tempora
estación (tren) → parada
estadio → estadia
estado → estatio
estadounidense → usono
estadística (concreta) → estadista
estadística (en general) → estadistika
estafa → zoiko
estalactita → espeleoka
estalagmita → espeleona
estallido → aixo
estancia → estanzia
estanco (donde comprar tabaco y sellos) → licentela
estandarte → estantaro
estante → axele
estantería → axelva
estar de pie, estante → estante
estatua → estatua
estatura → estatura
estaño → tenno, astin
este → este
estenografía → estenografia, estenografica
estequiometría → esteqiometria, esteqiometrica
estereografía → estereografia, estereografica
estereometría → estereometria, estereometrica
esternocleidomastoideo → esternocleidomastoideo
estilo → estila
estima → estima
estimación → estimatio
estiramiento → punxe, tritso
estiércol → tsisigra
estomatología → estomatologia
estomatólogo → estomatologo, estomatologette
estratigrafía → estratigrafia, estratigrafica
estrella de mar → marestrela
estrella → estrela
estructura → estrukta
estrés → anorro
estudiante → estarette
estudio → estaro
estufa → estufa
esturión → estsuela, esturion, cantsa
estándar → estandar
estática eléctrica → 
estómago → ingeriun
estúpido → esporgo
eternidad → ertsekoidae, ertse
etimología → etimologia
etimólogo → etimologo, etimologette
etiología → etiologia
etiqueta → nominoro
etnia → etnia
etnografía → etnografia, etnografica
etnología → etnologia
etnólogo → etnologo, etnologette
etología → etologia
etólogo → etologo, etologette
eucalipto → arsuce
eudiometría → eudiometria, eudiometrica
evento → evento
exageración → hurro
examen → examen
examinación → examinatia
exceso → posme
excitación → enuse
excremento de caballo, estiércol de caballo → ayatina
excremento de ciervo → deirina
excremento de gaviota → tagarina
excremento de murciélago, guano de murciélago → vesperina
excremento de paloma → peristerina, ragorina
excremento de pinguino → pengorina
excremento de vaca → vakerina
excusa → excusa
existencia → estaia
exobiología → exobiologia
experimento, test (científico) → testo, testifica, experimento, test
expiración, caducidad → expiratio
explanada → planiuno
explorador → forante, forette, explorator, explorante
explosivo → explodoro
explosión → bombeia
exportación → exporte
exposición (museo) → expositio
expresión → expresio
extensión → extentia
extintor → ignoextingoro
extranjero con pensamientos anticuados → estranigerneta, estranigerna
extranjero → estrane
extraño, desconocido → estranne
extremo → extremo
eyaculación → guma
faisán → fanso
falda → fuana, saia
falo → falo
falta → faita
fama → fama
familia → pailako, familia
familiar → pai
fantasma → fantasma, entsana, entsanos, entsanas
farmacología → farmacologia
farmacopsicología → farmacopsicologia
farmacólogo → farmacologo, farmacologette
faro (costero) → faro
favor → fevo
fecha → daita
fechas de vacaciones → ferehena
federación → federatio
felicidad → aibela
femicida → femicida, meiecida, meicida
femicidio → femicidio, femicidia, meiecidia, meicidia
fenología → fenologia
fenomenología → fenomenologia
fenomenólogo → fenomenologo, fenomenologette
feria → faira
fertilizante → feretina
fetiche → fetixa, kinko
feto → feto
fez → fez
fibra → fibre
ficción → fiktio
ficha → fitsa
fideo → fixoa
fiebre amarilla → fever mallea
fiebre → fever
fiel → faiette
fieltro → feltro
fiesta → festa, parta, faira
figura → figura
fila → linia
filmografía → filmografia, filmografica
filmología → filmologia
filo → fila
filología → filologia
filosofía antigua aidanesa por la que se elegía si el apellido de la madre o del padre debía ir primero o segundo en el nombre de su hijo; con el objetivo de darle una mejor estima → optima paternita
filosofía → filosofia
filólogo → filogette
filósofo → filosofette
fin de semana → finaolekso
fin → fin
final → finale
firma falsificada → signa fakro, fakrosigna
firma → signaro
fisiografía → fisiografia, fisiografica
fisiología → fisiologia
fisiopatología → fisiopatologia
fisiólogo → fisiologo, fisiologette
fitografía → fitografia, fitografica
fitología → fitologia
fitopatología → fitopatologia
fitosociología → fitosociologia
flamenco → flamingo
flamenco → flaminko
flamencología → flamencologia
flamencólogo → flamencologo, flamencologette
flash → flash, flax, bliqa
flauta → fluta
flecha → fletsa
flexión (ejercicio) → koratika
flor → floira
flora → flora
fluido → flogo
fluorimetría → fluorimetria, fluorimetrica
fobia → fobia
foca → purra
foco → foco
fogata → fogo
folclore → folklore
folio → fola
fondo → fondo
fonoaudiología → fonoaudiologia
fonoaudiólogo → fonoaudiologo, fonoaudiologette
fonofobia → fonofobia
fonografía → fonografia, fonografica
fonología → fonologia
fonometría → fonometria, fonometrica
fontanero → fontanette
fontanería → fontaneria, fontanika
fonética → fonetika
fonólogo → fonologo, fonologette
forma → forma
formación → formatio
formato → formato
fortuna → heleria
fosforo → fosfuro
fotobiología → fotobiologia
fotofobia → fotofobia
fotografía → fotografia, fotografica
fotograma → framo, frame
fotogrametría → fotogrametria, fotogrametrica
fotolitografía → fotolitografia, fotolitografica
fotometría → fotometria, fotometrica
fototipografía → fototipografia, fototipografica
fracción → fraktio
fractal → fractal
fragmento → fracto
frailecillo (animal) → frato
frambuesa → freruba, frambo
francotirador → ardespaire
frase → zance
fraseología → fraseologia
fregona → mope
freidora → friteoro
frenología → frenologia
frente → urante
frenólogo → frenologo, frenologette
fresa → fresa, estserra, rutsia
fresia (flor) → calanula
fresno → katria
fresón → frerna
friki (despectivo) → cix, weabu
friki de banderas → fliagacix
friki de libros, ratón de biblioteca → izbocix, sorette
friki de los deportes → esporcix, esportecix
friki de ordenadores → computercix
friki de videojuegos → jokocix, vidiojokocix
friki, sabido → goko
frisbee → frisbee
frito → frito
fruta → fruki
frío → aige
fucsia → fuksia
fuego → igno, foko
fuelle → fluma
fuente (origen), origen → origo
fuente → fonto
fuerza → forza
fuga → fuga
fular → fulard
full (mano de póker) → kompleto
fumador → esmokaiette
fundición → fuseitela
funeral → funeral
fusil → fusil
futbolista → futbolista, futbolette
futurología → futurologia
futurólogo → futurologo, futurologette
fé → fai
fístula → fistula
fórmula → formula
fútbol → futbola, poibola
gafas de sol → sologira, sologirit, solvisoioroit
gafas → ogira, ogirit visoioroit
galaxia → galaksis
galería → galila
galgo → galgo
galleta → putsa, cuki
gallina → conto, gaia
gallo → contino
gamba → ximbrarisa, ambo
gammagrafía → gammagrafia, gammagrafica
ganadero → eskiate
ganadería → eskiaro
gancho → katso
gandúl → sugarriyo
ganso → guse
garbanzo → berga
gardenia (flor) → gardenia
garra → giarra
garrapata → giarrapoita
gas → gas
gaslighting, luz de gas → mnemoruptura, gaslighting
gasolina → gasola, nitor, nafta
gasolinera → gasotela, nitortela, naftela
gasometría → gasometria, gasometrica
gastroenterología → gastroenterologia
gastroenterólogo → gastroenterologo, gastroenterologette
gastronomía → gastronomia
gatillo → triyo
gato (animal) → kato, menino, minino, katen, miko, felin, felino
gato (herramienta) → criketa
gato montés → savakato
gaviota → tagaro
gel → gel
gemelo → gineko
gemido → kemeido
gemología → gemologia
gemólogo → gemologo, gemologette
gen → gene
genealogía → genealogia
generación → espauna
generador → espaunaoro
general → general
genio → genio, ginio
genoma → genoma
gente → gente
geografía → geografia, geografica
geología → geologia
geometría → geometria, geometrica
geomorfología → geomorfologia
geomorfólogo → geomorfologo, geomorfologette
geranio (flor) → galina
geranio → alisla
gerontología → gerontologia
gerontólogo → gerontologo, gerontologette
gerundio → gerundo
geógrafo → geografette
geólogo → geologo, geologette
gigantografía → gigantografia, gigantografica
gilipollas → sudatso
gimnasia → gimnasta
gimnasio → gimnastela
ginecología → ginecologia
ginecólogo → ginecologo, ginecologette
ginofobia → ginofobia
girafa → gerafe
girasol → solavisa
giro → viro
glaciar → gielplaniuno
glaciología → glaciologia
glaciólogo → glaciologo, glaciologette
globo (juguete) → balun, globe
globo (terráqueo) → globe
gloria → gloria
glosario → glose, lexicon
glotología → glotologia
gnoseología → gnoseologia
gobierno → governo
gofre → xafla
golem → golem
golf → golf
golfista → golfista, golfette
golfo (geografía) → tago, girufa
golpe de estado → estatarrota
golpe inicial inesperado → transtava
goma (herramienta) → prusaioro
goma (material) → goma
gorila → korila
gorra → capa
gorrión → plomo
gorro → gorro
gota → dipo, tipo
grabación → grabatio, recordo
gracia →  graze
grado → grado
grafeno → grafeno
grafito → grafeto
grafología → grafologia
grafía → grafia, grafica
grafólogo → grafologo, grafologette
grajo → proke
gramática → gramatica
granito → granita
granizo → aigecombe
granja → granja
granulometría → granulometria, granulometrica
grapa → krapa
grapadora → kraporo
grasa → lipuda
gravedad → gravita
gravimetría → gravimetria, gravimetrica
graznido → cuaqio, grazne
greba → culdauro
grieta, raja → raca
grifo (agua) → espigoto
grifo (animal) → grifo
grillete → grileta
grillo → audixora
gripe aviar → acriko flubila
gripe española → espanna flubila
gripe porcina → porko flubila
gripe → flubila
grito → klizo
grosella → baretsa
grulla trompetera → trompescuela
grulla → escuela
grupo → lude, grupo
gruñido, guarrido → orko
gráfico (computación) → grafiko
gráfico (estadística) → grafika
grúa → gruva
guacamole → guacamole
guante → luva
guardabosques → madrasaivaixette
guardado → gaiza
guardador → gaizeoro
guardia → guarda
guarida → guardia
guerra → gerra, batailon
guerrero de fuego → antias
guijarro → giarra
guillotina → dantsoro, gillotina
guisante → pite
guitarra → gitarra
gula → glutonia
gusano → guro, colegi
guía (objeto) → redaioro
guía (persona) → redaixette
género → genera
haba → aba
habilidad → estila
habitación → vitaitela
habla → para
hablante → pairante, pairette, falante, falette
hacha → fasca
hada → farura
hagiografía → hagiografia, hagiografica
halcón → halokun, falcon, falco, condor
hallowen → halloween
halterofilia → halterofilia
hambre → zugra, fame
hambruna → urzugra, famina
hamburguesa → burgesa
hamster → peirala, milia
haplografía → haplografia, haplografica
haplología → haplologia
harina → hegoa
harpía → harpea
hater, odiador → rutrette
hechicero → xicero
hechizo, conjuro → xizo, praecanto
hecho → facto
heladería → gelatela, gelateria
helado → freskingo, gelato
helecho → ferna, honko
heliconia (flor) → gingola
heliografía → heliografia, heliografica
heliotelegrafía → heliotelegrafia, heliotelegrafica
helmintología → helmintologia
hematología → hematologia
hematólogo → hematologo, hematologette
hemofilia → hemofilia
hemofobia → hemofobia
heno → tseno
hepatología → hepatologia
hepatólogo → hepatologo, hepatologette
herbología → herbologia
herida → daxe
hermana → meileko, herna
hermanastra → inestmeileko
hermanastro → inestholeko
hermano → holeko, brodo
herpetología → herpetologia
herpetólogo → herpetologo, herpetologette
herradura → ayatuko
herramienta → horo
herrero → herrexette
herrería → herretela
heterofobia → heterofobia
heterosexual → heterosexualo
heterosexualidad → heterosexualita
hexágono → hexakono
hialografía → hialografia, hialografica
hibernación → bluma, hibernatia
hidrobiología → hidrobiologia
hidrogeología → hidrogeologia
hidrogeólogo → hidrogeologo, hidrogeologette
hidrografía → hidrografia, hidrografica
hidrología → hidrologia
hidrometría → hidrometria, hidrometrica
hidrotimetría → hidrotimetria, hidrotimetrica
hidrángea → hidranyea
hidrólogo → hidrologo, hidrologette
hielo → gelo
hierba → herba
hierofante → hierofante
hierofilia → hierofilia
hierro → herro
higrometría → higrometria, higrometrica
hijastro, hijastra → inesteko
hijo, hija → eko
hilo → ilon
hinduismo → hinduisma
hiperactividad → hiperaktivita
hipermetría → hipermetria, hipermetrica
hipnosis → hipnosis
hipodromo → ayatela
hipología → hipologia
hipopótamo → huragere, hipo
hipsometría → hipsometria, hipsometrica
hipólogo → hipologo, hipologette
histerología → histerologia
histología → histologia
historia → historia
historiografía → historiografia, historiografica
historiología → historiologia
histólogo → histologo, histologette
hobbista → hobbysette, hobbisette, jobisette
hobby → hobby, hobbi, jobi
hockey → hockey, hockei, jokei, jokey
hogar → heiga
hoguera → ignixa
hoja → fola
holografía → holografia, holografica
holograma → holograma
hombre → honperso
homenaje → homenaie
homicida → homicida
homicidio → homicidio
homofobia → homofobia
homografía → homografia, homografica
homología → homologia
homosexual → homosexualo, homoseksualo
homsexualidad → homosexualita, homoseksualita
homólogo → homologo, homologette
hongo → likena, fungo, tunga
hora actual → hentempo
hora de comer → ingora
hora del día mañanera → litair
hora → hora
horas extra → prolaboro
horizonte → horizone
hormiga → nekroandaivo
hormigueo → mitsisila
hormigón → concreto
horno → forno
horóscopo → horoscope
hospedaje → huste
hospital → hospital, hopital, kuratela
hostelero → hostexette
hostelerías → hosta
hostia → portona
hot dog, completo, perrito caliente → kalerhundo, sausixa
hotel → hostala
hoyo → hoio
hueso → hoso
huevo → ovo
humanidad → homoia, humanita
humano → homo
humo → esmoke
humor → zizge
huracán → hurakana
hurón → merreca
huérfano → horfano
huésped → husxette
huída → ezurra
hélice → gingilla
hígado → hexinra
icnografía → icnografia, icnografica
icnología → icnologia
icono → icone
iconografía → iconografia, iconografica
iconología → iconologia
iconólogo → iconologo, iconologette
ictiografía → ictiografia, ictiografica
ictiología → ictiologia
ictiólogo → ictiologo, ictiologette
idea → idea
identidad → identita
identificación → identitatio, identifatio
ideografía → ideografia, ideografica
ideología → ideologia
ideólogo → ideologo, ideologette
idioma, lenguaje → lango
idolología → idolologia
iglesia → eklesia, praisotela
ignografía → ignografia, ignografica
ilusión → iluda
imagen, foto → imake, pikto
imagenología → imagenologia
imaginación → imaginatio
imbécil → sunkrako
imperio → imperia
impersonación → imperso
imprenta → izkratasoro
impresión (impresionar, sorprender) → impresio
impresión (impresora) → izkro
impreso → izkrasato
impresora → izkroro
impuesto → taksa
impulso → busto
imán → magneto
inaccesibilidad → inakcesibila
incertidumbre → inzertidumbre
incienso → incenso
inclinación → eslanto, inklina
incomodidad → inconforta
incordio → proko
incubación → incube
inculto → ivorte
industria → industria
infancia → infantia, kindatia
infectología → infectologia
infierno → inferno, averno
infijo → infikso
inflación → inflatio
influencia → influentia
infografía → infografia, infografica
información → informa, infor, info
informática, computación → computio
infracción → frakza
infusión → infuzio
ingeniero → enginero
ingeniería → engineria
ingenio → enginio
inicio → initio
inmolación → inmolatia
inmunología → inmunologia
inmunólogo → inmunologo, inmunologette
inocencia → inocentia
inocente → inocente
insecticida → insekticida
insecto → insekto
inserción → inserzo
instalación → instalatio
instalador → instaloro
instancia → instancea
institución → instituzio
instituto → aito-esaroriun
instrucción → instruktio
instrumento → instrumento
insulto → insulto, retro, insulso
intelecto → intelekto
intención → intentio
intento → tre
intercambio, compra, adqusición → loge
interfaz → interfazia
internet → interneta
intervalo → interval
interés (economía) → rentaria
intestino delgado → piko intestino
intestino grueso → oxto intestino
introducción → intro
intruso → intrudo
inundación → fluvo
inventario → esmaretio
invernadero → aznatela, invernadero, aigelere
inversión → investa
investigación → edarotio
investigador → edarotto
invierno → aigelaria
invitación → invitatio
ira → ruztarro
iridología → iridologia
iridólogo → iridologo, iridologette
iris (flor) → iris
ironía → ironika
isla → isla
islamología → islamologia
islamólogo → islamologo, islamologette
isometría → isometria, isometrica
izquierda → zoraite
ión → ion
jabalí → diporko
jabón → moape, sapo, baxugo
jacinto (flor) → irsis
jack (cartas) → prince 
jade → jade
jalapeño → jalapenno
jamón → iamon
jaque (ajedrez) → jake
jaque mate (ajedrez) → jakemate
jarabe → gluco
jardinero → gardaxette
jardín → garda
jarrón, florero → diarra
jaula → xolda
jazmín (flor) → terisna
jefe → jefe, printsiale, antso, casca
jengibre → azura, raske
jerarquía → jiderarqia
jeroglifico → artisora, jeroglifia
jeroglifo → artiletra, jeroglifo
jersey → jersey, tuske
jirafa → terke, oxpisotsa
jornada → henata, iornada
joven (sustantivo) → neve, nevon
juego → joko
juegos de malabar → malabarit
juez → juksette
jugador de baloncesto → bolacester, bolacestette
jugador → jokaiette
juglar → joglar
jugo → xugo, yogo
juguete → juketo
juicio → juiska
junco → hunco
jungla → jungla
junta → junta
justicia → iustika
juzgado → jukse
katana → katana
kebab → kebab
ketchup → ketchup
kinesiología → kinesiologia
kinesiólogo → kinesiologo, kinesiologette
kiwi (animal) → kiwi
kiwi (fruta) → kiwi
koala → koala
kosovo → kosovo
kremlinología → kremlinologia
kremlinólogo → kremlinologo, kremlinologette
la sensacion de que alguien que conoces desde hace muchos años tiene una vida interior muy compleja y misteriosa que aún no sabes y que probablemente nunca sabrás → nosien
laberinto → mace
labio → labe
lado → sero
ladrillo → brico, kuxa
ladrón (aparato electrónico) → repardoro, elektrorepardoro
ladrón → rovette, rovago
lago → laka
laguna → lurge, lakata
laminado → lamino
lana → boure
lancero → esparette
langostino → ximpo
lanza → espara
lapislázuli → lapislazuli
laringología → laringologia
laringólogo → laringologo, laringologette
lasaña → lasanna
lata → canna
latín → latin
latón, azófar → laton
lava → lava
lavado → xaguata
lavadora → xaguatoro
lavanda (flor) → lavanda
lavavajillas → vadixaguaioro
leche → esnea, late, lato
lechero → esneaxette
lechuga → letsuga
lechuza → xendo
lectura → lekta
legumbre → tsikia
lejía → blanco
lema → leme, lema
lencería → linzeria
lengua → lemgo
lenguaje de programación → codilango, prokramalango
lente → lensa, lense
lenteja → tsiko
lentes → lendait
lentilla (gafas) → lense
lerdo → tsafala
letra (canción) → lerite
letra (símbolo) → letra
lexicografía → leksicografia, leksicografica
lexicología → lexicologia, leksicologia
lexicólogo → leksicologo, leksicologette
ley → laia
leyenda → legenda
leña → lenna
leñador → madrakuxette
león → leon
libertad → libertia
librería (estantería de libros) → librotela
librería → izbotela, libreria, librotela
libreta → izboiko, librete
libro elemental, vademécum, manual → vademecum, manual, primer, primera
libro → libro, sorate, izboto
licantropía → licantropia
licencia → licensa
licenciado → licenso
licuadora → licuatoro
licántropo → licantropo, licantropette
ligre → leogra
lija, lima (herramienta) → liya, afile
lima (color) → lima, lime
lima (fruta) → lima
limnología → limnologia
limonada → ciraela
limpiacristales → likravitro
limpiador → likraoro
limpiaparabrisas → likraparavendo
limpieza → likratia
limusina → limusina
limón → cirae
linterna → lanterna
liquen → liqen
liquidación (economía) → likidatio
lirio (flor) → mancuma
lista de cosas que hacer, conjunto de cosas que quedan por terminar → tudu, tudulista
lista → lista
litera → litera
literatura → literatia
litio → litum
litofotografía → litofotografia, litofotografica
litografía → litografia, litografica
litología → litologia
litoral → litoral, litora, inkoastatela
litólogo → litologo, litologette
llaga, pupa → yaga, yege
llama (animal) → lama
llama, llamarada (fuego) → flama
llamada → llamata
llanta → xenta
llanura → planitela
llave de tubo → tubekula
llave inglesa → martexo egrente
llave → klave
llegada → iriheia
lluvia de balas → baletrumbe
lluvia → pluva, acoata
lo más bajo posible que se puede estar en algo → afondo
lobo → lupo, vofen, licano, lauseto
locura → ankraia
lodazal → ugrarda
lodo → ugra
logo → logo, logette
logro → lokro
lombarda → lomba
lombriz → siguro, gago
lomo → rame
longitud → longoteda
loro → locuo, pargo
lucha, combate, pelea → fista
lucio → lutio
luciérnaga → blailita
lugar donde se origina una pandemia endemia o epidemia → punto zero
lugar propenso a desprendimientos → bocarra
lugar → locata, itela
lujo → luxo
lujuría → luxuria, luksuria
luna → luna
luz intermitente → litika
luz tenue → glima
luz → lita
lágrima → lacrima, lakrima
lámina → lamina
lámpara de araña → candelera, tsandelera
lámpara → litaoro
lápida → mortopetro
lápiz, lapicero → lapen, izkrioro, lapito
láser → lazer, laser
látigo → latikate
léxico, lexicon → lexico
líder → aderge, xefo
límite → limite
línea → linia
macarrón → makarron
maceta → mazeta
machacador → pestoro, morta
macrofotografía → macrofotografia, macrofotografica
madera → madra
madero → madreno
madrastra → inestmatrona
madre (formal) → matrona
madre → meipai
madriguera → maheiga
maestro → mastero
maestría → masteria
magdalena → magadia
magenta → magenta
magia → magia, haia
magma → magma
magnetismo → magnetisma
magnolia (flor) → magnasia
mago → mago, haiette
malabarista → malabarista
malacología → malacologia
malacólogo → malacologo, malacologette
malasombra → heuntsado
maldad → heunata
maldición → malditio
malhechor → heundoiette
malherbología → malherbologia
malva (color) → lula, malva
malva (flor) → lula
mamografía → mamografia, mamografica
mamut → mamuz
mamá → mama
mancha → zugra
mancuerna → pesejo
mandarina → oranjarina
mando (concepto) → manda
mando (objeto) → mandoro
manejo → tula
manera → modo
manga (ropa) → maniga
mango (de utensilios) → manega
mango (fruta) → mango
mania → mania
manicomio → frikostela, ankratela, frikheiga
manifiesto → manifesto
manillar → manile
manipulación → manika
maniquí → uperse, maniki
mano (póker) → mano
mano → man, hano
mansión → mansio
manta → kubre
mantarraya → manraia
manteca → manteca
mantenimiento → erso
mantequilla → mantega
manticora → mantikora
manutención → ersokio
manzana → menzana, pomo
manzanilla → pomotsa
maná → haia
mapa → mapa
mapache → mapatso, racune
maquinaria → matsinaria
mar → mare
maratón → maraton
marca → marka
marcador → markoro
marcha → martsa
marciano → marteano
marco → makora
marfíl → utso
margarita → aukuba
marica, maricón → zager
marido → honxa, honse
mariología → mariologia
marioneta → pupeto
mariposa → blaigia
mariquita → zigarra
mariscada, evento festivo típico del litoral; especialmente en Rioko donde se sirven grandes cantidades de mariscos → arrainata
marisco → arraina
mariólogo → mariologo, mariologette
marmota → marmota
marrón (una situación jodida) → injo
marsopa → osobe, ansabar
marsupial → marsupial
martillo → martexo
masa → masa
masacre → masacria
mascarada → maskerade, lufaz
mascarilla → mascarila, securitatia lufazia
mascota → heiganimal
masilla → masiya
masterización → masteratio
mastil → mastil
mastología → mastologia
mastozoología → mastozoologia
mastozoólogo → mastozoologo, mastozoologette
mastólogo → mastologo, mastologette
matadero → mataioro, mataitela, abatoro
matarratas → mortorratit
matasuegras → flocargoro
matemática → matematika
matemáticas → matematikas
matemático → matematico
material → materia
matraz, probeta → matrace, probacupa
matrimonio → zimisyoixo
matriz → matriks
maullido → mauia
mayonesa → maionesa
mayoría → oxtoro
mayúscula → alta
maza → maza
mazmorra, calabozo → calaboa
mazorca (maíz, por ejemplo) → bontso
maíz → juca
mañana (hora del día) → manza
mecanografía → mecanografia, mecanografica
mecansmo → mecanisma
mechero → ignoro
mecánica → mecania, mecano
mecánico → mecanette
medallón, objeto mágico que da suerte → siyil 
media (calcetín) → terza
media (matemáticas) → media
mediana → mediana
medianoche → mitanito
medicamento → medikare
medicina → medikar
medida → metirra
medidor → metera
medio (transporte, comunicación) → metia
mediocridad → mediocrita
mediodía → mitaheno
meditación → meditia
megáfono → megafono
mejora → baina
mellizo → meliza
melocotón, durazno → apomo
melodía → melodia
melografía → melografia, melografica
melón → meloko
meme → meme
memo, imitador → memo
memoria → memoria
mena → vena
menaje → furnitia, menagio
mención → mentio
mensaje → mesaje
menta → menta
mente → mende, mente
mentira → musta
menú → menu
mercado → logaplaza, mercato, market 
mercadología → mercadologia
mercadólogo → mercadologo, mercadologette
mercurio → mercuria
meridiano, husos horarios → meridian
merluza → xun, mutse
mermelada → iamela
mes → mes
mesa → lamadra
meseta → meseta
mesita de noche → nitomadra, nitolamadra, nitolama, nitica, lamadrila
metal → metala
metalografía → metalografia, metalografica
meteorito, meteoro → meteoro
meteorología → meteorologia, meteologia
meteorólogo → meteorologo, meteorologette, meteologo, meteologette
metodología → metodologia
metro (medida) → metro
metro (medidor) → metroro
metrología → metrologia
metrólogo → metrologo, metrologette
metáfora → metafora
mezcla → mixa
mezquita → mazquita
micetología → micetologia
micología → micologia
microbiología → microbiologia
microbiólogo → microbiologo, microbiologette
microfotografía → microfotografia, microfotografica
micrografía → micrografia, micrografica
microondas → microhuaba
micrófono → microfono
micólogo → micologo, micologette
miedo → terro
miel →  mela
mielografía → mielografia, mielografica
miembro (cuerpo) → membro
miembro (de un grupo) → membro
mierda → merto, keska
miga → minna, aya
mil → ailla
milagro → miraclo, miraculo, miracolo
milenio → aillano
milicia → milizia
militar → miliette
milla → mila
millón → milloe
mimeografía → mimeografia, mimeografica
mimo (cariño) → carica, memi 
mimo (persona) → memo
mina → mine
mineralogía → mineralogia
minero → minerette
minero, cavernícola → ergota
minería → minatia
minoría → pikoloro
minuto → minute
minúscula → cota
miología → miologia
mirador → avistela, mirator
mirmecología → mirmecologia
mirmecólogo → mirmecologo, mirmecologette
misionero → mesigette
misión → mesiga
misterio → misteria, edaro
mitad, medio → mita
mitin (política) → levado
mito → misto
mitografía → mitografia, mitografica
mitología → mitologia
mitólogo → mitologo, mitologette
mitómano → mitomane
mnemotecnia → mnemotecnia, mnemoteknia
mochila → esaibaga
moco → muco
moda → siska
modalidad → modole
modelo → model, modelo
moderador → moderaiette
modificación → modifikatio
modo → modo
mofeta → napesta
moho → moldo
molde → molde
momento → tempeo
monadología → monadologia
moneda → pinne
monitor → dorimeder
monje → reculen, bonzo
mono → monki, aco
monociclo → monorroda
monografía → monografia, monografica
monográfo → monografette
monolito → monolito
monstruo → monstro
montaña → montanna, ampico
monte → monto, monde, monte
montículo → kieva, montinna
montón (cosas) → buntso, cumo, kieve
montón (es un montón!) → plenti 
monóculo → monoklo
monólogo → monologo
moqueta → mokete, moqete
mora → blurra
morfofonología → morfofonologia
morfología → morfologia
morfometría → morfometria, morfometrica
morfólogo → morfologo, morfologette
morsa → tapelo
mortero → morta
mosca → blainekro
mosquete → muskete
mosquito → moskito, mosqito
mostaza → mostara, merla
motivación → motivatio
motivo de guerra → casus belli
motivo → motivo
moto → motorroda
motocicleta → motorroda
motor → motor
motosierra → motorxerra
motín → motin
movimiento → mova
mueble → furno, moblo
muela → mola
muerte → morto
muerto → morte
muestra → dorima
mugre → mugar
mujer → meiperso
multiplex → multiplex
multitud → multita
mundo → mondo
mundología → mundologia
munición → amunitio
muralla → murala
murciélago → vesperilo, murelo
murmuro → suro
muro, pared → mura
museo → museio, expositio, museum
museografía → museografia, museografica
museología → museologia
museólogo → museologo, museologette
musgo → moso
musicología → musicologia
musicólogo → musicologo, musicologette
muñeca (brazo) → intso
muñeco, muñeca (objeto) → doli, clutso
máquina → matsina
mármol → marbel
máscara → lufazia, maske
médico → medikarette
módem → modem
módulo → modulo
música → musika
música → musikette
nacimiento → natatia
nacionalidad → agizaia
nadador → natairette
nanotecnología → nanotecnologia
napolitana → miniga
naranja (fruta) → oranja
narciso (flor) → nersu
nariz → vono
narratología → narratologia
narratólogo → narratologo, narratologette
nativo → nativo
naturaleza → natura
navaja → navaia
nave → nave
navegador (internet) → brouser, browser
navidad → neven
nazi → nazi
nazismo → nazismo
nebulosa → nebula
necesidad → traia
necrofilia → nekrofilia, necrofilia
necrofobia → nekrofobia, necrofobia
necrología → necrologia
nectarina → nipomo
nefelometría → nefelometria, nefelometrica
nefología → nefologia
nefrología → nefrologia
nefrólogo → nefrologo, nefrologette
negación → noneatio
nematodo → serle
nenúfar → nufara
neología → neologia
neonatología → neonatologia
neonatólogo → neonatologo, neonatologette
neumología → neumologia
neumático → kotsira
neumólogo → neumologo, neumologette
neurobiología → neurobiologia
neurobiólogo → neurobiologo, neurobiologette
neuroembriología → neuroembriologia
neuroembriólogo → neuroembriologo, neuroembriologette
neuroendocrinología → neuroendocrinologia
neuroepidemiología → neuroepidemiologia
neurofisiología → neurofisiologia
neurofisiólogo → neurofisiologo, neurofisiologette
neurología → neurologia
neurólogo → neurologo, neurologette
neutrón → neutron
nevera, frigorífico, refrigerador → ingoesmar
neólogo → neologo, neologette
nido → nesta
niebla → nubula
nieta → meioeke
nieto → umoeke
nieve → aigela
nigromancia → nekromantia
nigromante → nekromante
nitrogeno → nitroieno
nivel → levela
niña → nenna
niñez → kindeka
niño → kindo, infante, nenno
niños (conjunto) → kindara
noche → nito
nogal → nuzelara
nombre → nome
nomografía → nomografia, nomografica
norma → norme
norte → norto
norteño → tsemika, noro
nosografía → nosografia, nosografica
nosología → nosologia
nostalgia → nostalgia
nota → nota
noticia → neva
notificación → nevari
novedad → nevotia
novio, novia → loimike
nube seta → likenimbo
nube → nimbo
nudo → nude
nudo → nukra
nueve → nonio
nuez → nuzel
numerología → numerologia
numerólogo → numerologo, numerologette
nutricionista → dietexette
nutriología → nutriologia
néctar → nektar
níscalo → niscalo, mixuia
núcleo → kora
número impar → impare
número par → pare
número → numo, emesimo
obelisco → obeliskos
obispo → bispo
objetivo → asiga
objeto → item
observatorio → miratorio
obsesión → atainara, oclura
oca → malira
oceania → oceania
oceanografía → oceanografia, oceanografica
ocho → octo
ocio → ocio, xia, ozio
octógono → oktokono
ocupación → osala
océano → ozeano, oxtomare
odio → rutro
odontología → odontologia
odontólogo → odontologo, odontologette
oeste → oeste
ofensa → ofensa
oficina → ofizina
oficio → ofizio
oftalmología → oftalmologia
oftalmólogo → oftalmologo, oftalmologette
ojo → exo, ogo
ola → guaira
oleografía → oleografia, oleografica
oliva → oliva
olla → kalerkista
olmo → elme
olor → eslo
olvido → huske, suparde
oncología → oncologia
oncólogo → oncologo, oncologette
onda → huaba
onomasiología → onomasiologia
ontología → ontologia
ontólogo → ontologo, ontologette
opción → setegia
opinión → penza, penze, opinio
oportunidad → eiasa
optometría → optometria, optometrica
oración → oratio
orangután → ursunna, nono
orchata → esnika
orden (de orginazar) → surdo
orden, ordenación → ordo
ordenador portátil, portátil → laptopa, laptop, portcomputera
ordenador, computador → computera
oreja (calzado) → herro da bota
oreja, oido → oitio
orfanato → horfanatela
organismo → organismo
organización → organizatio
organografía → organografia, organografica
organología → organologia
orgía → orgia, anxia
orina → urina, urin
orla → aserna
ornitología → ornitologia
ornitorrinco → tuputa
ornitólogo → ornitologo, ornitologette
oro → aurio
orografía → orografia, orografica
oronja → oronya
orquesta → orqesta
orquídea (flor) → ortsida
ortiga → urtica, migera
ortografía → ortografia, ortografica
ortología → ortologia
ortotipografía → ortotipografia, ortotipografica
ortólogo → ortologo, ortologette
oráculo → oraculum
orégano → parxa
oscuridad → obskuridae, obskurita, auskuria
oso → aubaso, urso
osteología → osteologia
osteólogo → osteologo, osteologette
otología → otologia
otorrinolaringología → otorrinolaringologia
otorrinolaringólogo → otorrinolaringologo, otorrinolaringologette
otoño → autonno
otólogo → otologo, otologette
oveja → ovia, omejo, aboura
ovni → estranne blaiette artefactum, eba
ozono → ozone
paciencia → pacenza
paciente cero → casus index, casus primer
pacto → pacto
padrastro → inestpatrono
padre (formal) → patrono
padre → honpai
paella → paella
paga → paia
pagano → pakano
paidología → paidologia
paisaje → escape
paja (heno) → likra
paja (sexo) → oarga
pala (herramienta) → eirgoro
palabra → vorto, palabra
palabrería → vortatia
palabrota → cusa, vourage
palanca → palanca
paleoantropología → paleoantropologia
paleoantropólogo → paleoantropologo, paleoantropologette
paleobiología → paleobiologia
paleobiólogo → paleobiologo, paleobiologette
paleofitopatología → paleofitopatologia
paleografía → paleografia, paleografica
paleontografía → paleontografia, paleontografica
paleontología → paleontologia
paleontólogo → paleontologo, paleontologette
paleopatología → paleopatologia
paleopatólogo → paleopatologo, paleopatologette
paleta → paleta
paleólogo → paleologo, paleologette
palinología → palinologia
paliza → puntsatarra
palma → palme
palmera (árbol) → irakoa
palo (cartas) → kolor
palo → apika, cano, cana
paloma → rago, pumo
palomita (comida) → explojica
pan de molde → anglobrita
pan → brita
panadero → britaxette
panadería → britatela
panal → panala
panceta → porketsa
pancreas → pancras
panda → panda
pandemia → pandemos
panderetólogo → panderetologo, panderetologette
panel de control → controlpanela
panel → panela
pansexual → pansexualo
pansexualidad → pansexualita
pantalla → visaya, tele
pantalón → panto
pantano → saguala, zanga
pantera → pantera
pantufla → bourisa
papada → ploka
papaya → papaya
papel higiénico → pipranusa, culepipra
papel → pipra, fola
papelera, cubo de basura → graxkubo, zorrera, zorrere, desextela, zorvero
papelería → pipratela
papeleta → pipro
papilla → papila
papirología → papirologia
papirólogo → papirologo, papirologette
papá → papa
paquete (insulto) → tsusta
paquete (objeto) → paketara
paquete → pakete, endevo
par → pare
parabrisas → paravendo
paracaídas → paratsute
paradoxografía → paradoksografia, paradoksografica
parafilia → parafilia
paraguas → pluvaoro
parapsicología → parapsicologia
parapsicólogo → parapsicologo, parapsicologette
pararrayos → pararaio
parasicología → parasicologia
parasicólogo → parasicologo, parasicologette
parasitología → parasitologia
parasitólogo → parasitologo, parasitologette
parasol → estosol
paraíso → paradiso
pareidola → pareidolia
pareja (mano de póker) → paren
pareja → paren
paremiología → paremiologia
paremiólogo → paremiologo, paremiologette
pariente → pai
parking, aparcamiento → parakia
parque → parke, jokotela
parrilla → grila
parroquia → parroqia
parte → parte
participio → partizipio
partida (juego) → jokaizara
partido (juego, deporte) → jokaizera
partido (político) → partero
parásito → paraisto, verme
pasado → pasato
pasamontañas → balakava
pasaporte → pasporte
pascua → paske, dominko da resurrectio
paseo → andaiata
paseo → paizo
pasillo → andaio
paso de zebra → rakempisa
paso → pisa
pasta (comida) → fixolo
pastel → kutsa, boglo
pastilla → gobo
pastillero → gobocupa
pastor → pastoro
pata (animal) → pezna
patada → poitsa
patata → torkopa, tata, papa, potata, patata
paternidad → paternita
patio → enkampe, kampe
pato → ana
patografía → patografia, patografica
patología → patologia
patria → onterra, patria
patriarca → onterrarge, patriarka
patrología → patrologia
patron → patronna
patólogo → patologo, patologette
pausa → haile, hailo, pause, pauxe, pauxa, pausa
pavo real → cocolito
pavo → cocol
payaso → payaso, xiabette
paz → paz
país → landa, agiza, paiseko
pañuelo → pannola
pecado → xina
pecera → pesketela
pechera → koraton
pecho, torso → korata
pechuga → same
pedernal → petelo
pedido → orden
pedo → fargo
pedofilia → pedofilia
pedofobia → pedofobia
pedología → pedologia
pedorro → fargustarra
pegamento → pasta
pegatina → pastenno
pegatina → pastika
peine → cailoro
pelador de patatas → torkopeler
pelador → peler
peladura → pelde
pelaje, cuero → cuoro, peltro
pelea (informal) → litsa, faita, pugna
peletero → cuorette
pelicano → pelico
peligro → perila
pella → peia
pelo, cabello → cailo
pelota, bola → bola
peluquero → cailoxette
película → filmo
pendiente (vestir) → kirla
pene → penisa, sakiya, pikla
pensamiento (mente) → penze
pensamientos (flor) → siakara
pentalogía → pentalogia
pentágono → pentakono
península → peninsula
peonza → virante, rotaio
peonía (flor) → aravita
pepinillo → frico
pepino → pepera
pepperoni → pepperoni, peperoni
pera → pera
perca → eskada
percha → pertsa, colca, colga
perdición → perditio
perdiz → lombo
perdón → diskaire, pardon
perejil → kila
perenne → perene, perenne
pereza → fiagia, partsa
perezoso (animal) → fiager 
perfección → perfektio
perfil → profila
perforación → perzro
perforadora → perzroro
pergamino → perge
periodista → henpixette
periodo (tiempo) →  yero
periodo, regla (cuerpo) → periode
periquito → beke
perisología → perisologia
periódico → henpipra, nevapipra
perla → perla
permiso → permiso
perro salchicha → junzundo
perro → hundo, doerro, canino, canin
persa → persa 
perseverancia → persevera
persiana → yera, jerco
persistencia → persivita
persona (forma muy formal) → persona
persona de piel clara → aluran
persona de piel oscura → turan
persona que para crecer o beneficiarse él mismo es capaz de pisar a los demás → aurataiette 
persona que siempre está emocionada por todo; a veces de forma nerviosa y agitada; o que te cuenta cosas poco interesantes con mucha emoción hasta un punto que es molesto → panfilos
persona → perso
persona; generalmente de la tercera edad; que gusta de contar historias y anécdotas de su pasado, viejo cebolleta → disketabroka
personaje → tsarakto
personal → personale
personalización → personalizatio
personificación → persoia
pesa rusa → giria, kettlebell 
pesa → pesa
pesadilla → heupentsi, heupentsio
pesca → peska, pesko
pescadero → peskovente
pescadería → peskotela
pescado → peskoto
pescador → peskorette
pesebre → bestingoro
peso → peso
pestaña (informática) → tabula
pestaña (ojo) → exogi
peste antonina → antonine pesta
peste negra → nekro morto
peste → pesta
pesto → pesto
petrografía → petrografia, petrografica
petroleología → petroleologia
petrolero → nekrasobarco
petrología → petrologia
petróleo, crudo → nekrasoa
petunia (flor) → porpura
pez globo → acoabalun
pez → pesko
peña → penna
peñasco → pennasco
peón → peon
phasmofobia → fasmofobia, phasmofobia
piano → piano
picadura → estundaxe
picas (palo de poker) → pika
picnic → picnic
pico (animal) → pike
pico (herramienta) → pikote
pico (montaña) → ampico
pictografía → pictografia, pictografica
pie de texto → entesora, poscritum
pie → poi
piedra caliza → limapetro
piedra papel tijera → petra fola akuto
piedra → petro, petra
piel → pelde
pierna → airpoi
pieza pequeña utilizada en deportes de duelo que se asigna al jugador mejor considerado antes de una partida para que si este pierda en señal de respeto se lo da al ganador en mano como símbolo de buen perder → madrito, madrita
pieza → pieza
piezometría → piezometria, piezometrica
pijama → niki
pilar, columna → pilo
pimiento → pipera
pincel → brutsa
pincelada → brutse
pinche (ayudante de cocinero) → adkoxine, koxinlada
pincho → pinko
pinguino → pengino, pengo
pingüino → pingino
pinnipedo → escua
pino → pino
pintor → pintette, pinterette
pintura (cuadro) → pintaia, pikto
pintura (objeto) → pinta
pintura rupestre → antiopinto
pinza → sujeta
piojo → pioyo
pipa → crutsa
pira (fuego) → pire
piragüa → piragua
piraña → piranna
piretología → piretologia
pirografía → pirografia, pirografica
pirología → pirologia
piromanía → arsonisma 
pirometría → pirometria, pirometrica
pirámide (forma geométrica) → piramide, frustro, frustrum, frusto, frustum
pirámide → piramide
pirómano → arsonista, piromanette
pirómano → piromane
pis → pikse
piscina → acoakisa
piso, apartamento → empartamento, bloke
pista (sobre un misterio) → hanta
pista de baile → danzeplane
pistacho (color) → pistatso, olive
pistacho (fruto seco) → petsula, pistatso
pistola → pistola
pitaya → noisa
pizarra (escuela) → zirraplane
pizarra (material) → ekurga
pizza → pizza
pizzería → pizzatela
piña → pinna, anani
placa → plata
placenta → ecombe
placer → pleasa
plaga de justiniano → plaga dai justiniano
plaga → plaga
plan → plan
plancha → plankoro
planchas de madera → planko
planeo → planeata
planeta → planeta
planetoide → planetoido
planimetría → planimetria, planimetrica
plano → plane
planta (flor) → planta
planta petrolífera → nekrasoatela
planta violácea utilizada para crear el té purpur → purpur
planta, piso, suelo → piso
plantilla → petrobase
plasma → plasma
plata → silvo
plataforma → plataforma
platino → silverino
plato de ducha → tsoage, tsoaglate
plato → plato
playa → plaia
plaza → plaza
plomo → blono
pluma (animal) → felisa
pluma (boligrafo) → pluma
plutonio → plutonio
plutón → pluto
pluviometría → pluviometria, pluviometrica
plátano → banana
población → populatio
pobreza → poratia
poción → potia
poder → ponto
podofilia → podofilia
podología → podologia
podólogo → podologo, podologette
poema → poema
poesía → poesia
polarimetría → polarimetria, polarimetrica
poledance → poledance, poledanza, poledanze
polemología → polemologia
policía (coloquial) → controletta, controlette
policía (en general) → polizia
policía (persona) → polizette, securette
poligrafía → poligrafia, poligrafica
polimetría → polimetria, polimetrica
politicólogo → politicologo, politicologette
politología → politologia
politólogo → politologo, politologette
polla → naso
pollo → acriko, nase
polo (helado) → polo
polo → pole
polvo (algo pulverizado) → pulder
polvo (suciedad) → droupe
polén → polen
políglota → polingo, moltopara
polígono → moltoxo
pomelo → froki
pomología → pomologia
pompa → bobal, pompe
pomólogo → pomologo, pomologette
poncho → pontso
por defecto → nurdefekto
porche → escuara, esquara, arkubre
porción, rodaja, trozo (comida) → kuton
pornografía → porno, pornografia
poro → poro
porro → purro
portaaviones → portavionnit
portabandera → portafliaga
portabebés → portabekit
portavoz → portavoz
portero → portette
portería → porteria, porta
posavasos → posakisa
pose → pose
posesivo (lengua) → posesive
posición → posaieo, positio
posología → posologia
postal → postal
postdata, postscript → poscritum
poste → poste, forco
postre → sundo, postre
postura → poste
pozo → racoia
pradera → ergiara, razna
prado → ergia
precio, coste → kosta
precisión → prezisio
predicado → predicado
predicador → prediqette
predicción → prediktio
preferencia → sesaia
prefijo → prefikso
pregunta → kuastion, kuasta
premio → premio, prizo
prenda → perda
prensa → prenza
preocupación → lana
preparación → preparatio
presentación → presentatio
presente → presente
presidente → presideixette, printsiale
presión → preso
pretecnología → pretecnologia
pretexto → endeba
previsión → prevo
previsualización → previso
primate → primate, primero
primatología → primatologia
primatólogo → primatologo, primatologette
primavera → acoatira
primo → teoleko
princesa → princese
principado → princeta
principal → printsiale
principiante → initiaxette
principio, comienzo → initio
prisa → ranta
prismáticos → visforo
probabilidad, chance → tsance, chance
probatina → tinka
probiótico → probiotiko
problema → problema
procedencia → proceda
procesador → procesoro
proceso → prozeso
proctología → proctologia
proctólogo → proctologo, proctologette
productividad → produktivita
producto → produkto
profesional → profesionale
profesión → profesio
profesor → esaroette
profeta → profeta
programa → prokrama
programación → prokramatio, codin
progreso → progreso
promedio → promedia
promesa → priosa
pronóstico → pronostiko
propuesta, petición → petitia, precaia
prosopografía → prosopografia, prosopografica
prosperidad → prosperatia
prostituta → putarra
protección → protectia
proteína → proteina
protón → proton
proverbio → proverbio
provincia → provenza
proyectil → proyectila
prueba → proba
prímula → acuprila
príncipe → prince
prólogo → prologo, prologette
pseudología → pseudologia
psicobiología → psicobiologia
psicofisiología → psicofisiologia
psicología → psicologia
psicometría → psicometria, psicometrica
psicopatología → psicopatologia
psicosociología → psicosociologia
psicosociólogo → psicosociologo, psicosociologette
psicólogo → psicologo, psicologette
psicópata → psicopata
psíquico → psiqico
pua → pika
pueblo → popula
puente → ponto
puercoespín → pigotira
puerro → leko, kelena
puerta → porta
puerto → porto
puesta de sol → solarga, solposai, solposa, solmorta
puesto → posto, estando, estan
pulgada → pulgada
pulmón  → polmona
pulpo → pulpusa
pulsera → intsina
puma → pambo
punta, pincho → nila
punto de mira, diana → nesiga
punto → punto
puntuación → puntuatio, puntuo
puré → tritura
puta → puta
puñal → estavoro
puñetazo → punanda
puño → puna
página web → webpagena
página → pagena
pájaro → payoa, caco
párpado → exore
párrafo → parrafo
péndulo → pendulo
pértiga → felto
pícido, pájaro carpintero → madraco, pincano, picide
píxel → pixel
póker (mano de póker) → catro equalit
póker → poker
pólvora → pulder forte
pórtico → portecum
público → publiko
qubit → qubit
quedada → quaro
quehacer → doidute
quelea → porve
quemador → ignodoxoro
quemadura → ignodaxo
queso en polvo → pulverfruge
queso → fruge
quiebra → qibra
quinesiología → qinesiologia
quinesiólogo → qinesiologo, qinesiologette
quinteto → qinteto
quiz → quiz
quokka → cuoca
racha → sigatia
racismo → razisma
ración → ration
radio (aparato) → radio
radio (elemento) → radio
radiobiología → radiobiologia
radiografía → radiografia, radiografica
radiología → radiologia
radiometría → radiometria, radiometrica
radiotelegrafía → radiotelegrafia, radiotelegrafica
radián → radian
radiólogo → radiologo, radiologette
rama → brianke, anka
ramen → ramen
rana → acroa
rango → range
ranunculus → ranuncula
rapidez → ranto
rascacielos → kailokikro
rasta → rasta
rasuradora (manual) → razor, razoro
rata de agua → acorrata
rata → rata
ratio → ratio
ratón (animal) → roido
ratón (ordenador) → mouse
rayo → raio
raza → raza
razón → reaso
raíz → braine
reacción → reaktio
reacción → reakto
reactor → reactoro
realidad → realita
rebaño, ganado → eskio
rebozuelo → mallea turfa
rección → rektio
recepción (juegos) → receptio
recepción (lugar) → receptela
receptor → receptoro
receta → receta
recibimiento → recepta
recicladora → rezykloro
reciclaje → rezyklatia
recipiente → recipente, kisa
recogedor (objeto) → rekainoro
recogedor (persona) - rekaixette
recogida → rekaina
recompensa → reguardo
recorte → rekuta
recto → recto
rector → rektor
recubrimiento, cápsula, protección, trinchera, nido, bunker, guarida → laira
recuento → rekonto
recuerdo → memoir
recuerdo → rekordo, supte
recurso → rekurso
red de pesca, trampa para atraer turistas con el objetivo de sacarles mucho dinero → arraineta
red local → localneta, neta locatako, 
red social → sozialneta
red → neta
redil → qalem
reembolso → refunda
reenvío → redario
referencia → refera
reflejo → espelektia
reflexión → refleksia
reflexología → refleksologia
reflexólogo → refleksologo, refleksologette
refresco → fiztrinka
regadera → rekaoro
regaliz → dultseza
regalo → regalo, presente
región → regiono
regla → rekla
regreso, retorno → retorno
reina (póker) → dama
reina → reine
reina, dama (ajedrez) → meila
reinado → reina
reino → renno
reintentar → retrei
relación → relatio
religión → relicro, reculo
reliquia → relicua
relleno de una almohada → bourege
reloj de muñeca → klokonna
reloj despertador → lotoro
reloj → kloko, relox, horaviso
remasterización → remasteratio
remo → esguela
remolacha → grosatsa
renacido → renaizo
renacimiento → renaizento
rendición → purna
reno → kirko
renovación → renevo, reneva
reología → reologia
reparación → repaira
repartidor → repardette, repartette
repetidor → repeteoro
reporte → reporta
repositorio → repositorium
repostería → sundere
representación → representatio
reprografía → reprografia, reprografica
reptil → reptile
repuesto → tsargo
república → republika
reserva → reserva
residencia → reisitela
residente → reiso
residuo de litio de las baterías → litumgrax
residuo → guasta, grax
resistencia → resistentia
resolución → resoleitio
respeto → respeto
respiración → rispera
respuesta → reposta
restaurante → restorante
resto → reste, resto, zorve, deproxo
restricción → restrikta
resultado → resola
resumen → sumari
resurrección → resurrectio
retener → ataina
reto → testa
retrasado → retartato, retardato
retraso → retra
retroceso → retre
retrógrada, persona en contra de las cosas nuevas → igerneta, retrograda, retrograde
reumatología → reumatologia
reumatólogo → reumatologo, reumatologette
reunión → undizio
revolución → revolutio
revólver → revolver
rey (póker) → rein
rey → rein
rezo → praiso
riachuelo → lenda, riatsa
rienda → qale
riesgo → risko
rifle → rifle
rima → rima
rinoceronte → rino
rinología → rinologia
rinólogo → rinologo, rinologette
risa → gisa
ristra → rister
ritual → ritual
rizo → rize
roble → acaia
robo → rovo
robot → robot
roca gigante → bocarro
roca → roca
roce → rotse
rodilla → gidilla
roedor → rodento
rol → rol
rollito → roloki
rollo → rolo
romance → romanze
rombo → rombo
romero (flor) → romo
ron → rone
ronda → ronda
ropa → ropa, vano
rosa → roixa
rotación → rotatio
rotulador → rotulaoro
rotura → rotura
rubí → ruby
rueda → roda
ruido → noiso, ruido
rumor → unzuna
rumorología → rumorologia
ruta → rota
ráil → riel
récord → rekord, plusmarka
régimen → regimeno
río → acuokemno, riava
rótulo → rotula
sabana (bioma) → xabana
sabiduría → onatia
sabor → zapor
sacacorchos → retrakorkoit
sacarimetría → sacarimetria, sacarimetrica
saco → sako, sak
sacrificio → sacrifitio
sakura, cerezo → roixeral
sal → sale, sial
salamandra → zirno
salchicha → karnolon, sausoxo, soyo
saldo → saldo
salero → salekisa
salida → evokatela
saliente → evoke
salmón → tsugo
salpicadura → tsaia
salsa tártara → tartara, tartaruma
salsa → sauza
saltador → pulaioro
saltamontes → herbepulai
salto → pula
salud → vitaiko
saludo → saluto
salvapantallas → visayagaizere
salón → asteitela
sandalía → sande
sandía → roxomelo
sangre → sigra
sanidad → sanita
santo → sainto
santuario → saintotela
sapo → froga
sargento → sarjento
sartén → emfriteoro
satélite → satelita
sauce llorón → zaprusa
secador, secadora → drioro
sección → sektion
secreto → sekreto
secta → sekta
secuencia → sequencia
sed → renacoa
seda → seda
sede → primertela
segundo → sekundo
seguridad → securitatia
seguro (algo que asegura) → secur
seis → sexei
selección → selektio
selenografía → selenografia, selenografica
sello → seldo
semana → olekso
semasiología → semasiologia
semen → bila
semilla → semila
semiología → semiologia
semiólogo → semiologo, semiologette
semáforo → sinnali, semaforo
senda → kemno
seno (matemáticas) → sino, seno
seno (tetas) → seno, senu
senografía → senografia, senografica
senología → senologia
sensación (moda) → sensation
sensación (sentir algo) → sensa
sentido → senso
sentimiento → sensira
senólogo → senologo, senologette
sepsis → sepsis
septágono → septakono
sepultura → sepulta
sequía → dria
sequía → eskarratia
serie de televisión → tiviserie
serie → serie
serigrafía → serigrafia, serigrafica
serología → serologia
serpiente cascabel → crotalo
serpiente → serpento
serrería → madratela
servidor → sirveidoro
sesión → sesia
seta, champiñón → tsampinna, tunga
seudología → seudologia
sexo → sexo, sekso
sexología → seksologia
sextante → sekstanta, sextanta
sexólogo → seksologo, seksologette
seña → sinna
señal → sinna
señor → sire
señora → sira
sicobiología → sicobiologia
sicofisiología → sicofisiologia
sicología → sicologia
sicometría → sicometria, sicometrica
sicopatología → sicopatologia
sicosociología → sicosociologia
sicosociólogo → sicosociologo, sicosociologette
sicólogo → sicologo, sicologette
sidra → cidra, sidra, sider
sierra de calar → nivoxerra
sierra → xerra
siete → septo
sifilografía → sifilografia, sifilografica
sigilografía → sigilografia, sigilografica
siglo → ozeno
significado → mea
silencio → esparo, unoio
silla → senda
sillón → sendaron
simbología → simbologia
simetría → simetria, simetrica
simpatizante → simaisere
simpatía → simaiso
simplex → simplex
sinología → sinologia
sintomatología → sintomatologia
sinólogo → sinologo, sinologette
sinónimo → sinonimo
sirena (mitología) → meimare
sirena (objeto) → sirena
sirvienta, sirviente → madem
sirviente → sirveinte, servente, titse
sismología → sismologia
sismólogo → sismologo, sismologette
sistema solar → solarsistema
sistema → sistema
situación en la que una persona es vigilada por la posibilidad de que sea un criminal, situación de grave peligro de caza; captura o asesinato → hepsis
slime → limo, eslimo, eslime, slime, slimo
soberbia → superbia
sobrino → asineko
sociedad completamente basada en el dinero; donde el que tiene más dinero tiene inevitablemente más poder y donde la desigualdad entre las clases sociales es muy alta → luxocrasis, luksocrasis
sociedad → soziata
socio → sozio
sociobiología → sociobiologia
sociobiólogo → sociobiologo, sociobiologette
sociología → sociologia
sociometría → sociometria, sociometrica
sociólogo → sociologo, sociologette
sociópata → sociopata
sofrología → sofrologia
sofrólogo → sofrologo, sofrologette
sofá → sofa
soga → soka
soja → soya
sol → sol
solar, parcela → solar, parza
soldado, guerrero → gerraxette
soledad → ekoria
solitud → ekorasia
solución → solva
somatología → somatologia
sombra → tsado
sombreador → tsadoro
sombrero → tsadoya, horro
somnofilia → somnofilia
sonido de estática eléctrica → vizel
sonido → soniko
sonrisa → sela
sopa → faba
soplido → sopolo, flo
soteriología → soteriologia
spoiler → espoiler, spoiler
subida → aira
submarino → submarine
subnormal → tardo, subnormailo
suceso → bero
sudor → sueta
suelo → piso
suerte → lagenda
sueño → pentsio
sufijo → sufikso
sugerencia → sugestia
suicida → suicida
suicidio → suicidio
sujeción → suje
sujetador → sujeizo, braz
sujetapapeles → sujepipra
sujetavelas → sujecandala
sujeto (persona) → sujeto
superavit → superavit
superficie → supratela
supernova → supernova
supervivencia → surviva
sur → sur
surgimiento → sagetia
sushi → sushi
suspensión → reprovatio
suspenso → reprovo
sustancia → sustancea
sustantivo → nambiro
sustento ,  sostención → soteno
sustituto → sekundoro
susurro → huxa
sábana (cama) → xiaga
sílaba → silaba
símbolo → simbolo
símbolo, signos → simo
síndrome → sindroma
sólido → solido
tabaco → tavake
taberna → ingotela, taverna, taberna
tabique → privono
tabla → tablo
tablero → tablote
tacaño → takanno
taco → taco
tafofobia, tapefobia → tafofobia, tapefobia
tahr → tare
taiga → taiga, karzufisi
takín → takin
taladro → talatro
talasofobia → talasofobia
talco → talco
talisman → talisman
talla → rango
tallo → rute
tamaño → tamanno
tambor → tampol
tanatofobia → tanatofobia
tanatología → tanatologia
tanatólogo → tanatologo, tanatologette
tangente → tangente, tangento
tanque, vehiculo de guerra → basta
taparabos → sujenasoit, sujenasit
tapír → tapire
taquigrafía → taqigrafia, taqigrafica
taquimecanografía → taqimecanografia, taqimecanografica
taquimetría → taqimetria, taqimetrica
tarde → taren
tarjeta de crédito → bancarde, bankarde
tarjeta de débito → dute bancarde, dute bankarde
tarjeta, carta de naipe → carde
tarrina → tarra
tarro → tarro
tarsero, tarsio → tarso
tarta → tarta
tarántula → tarantula
tautología → tautologia
taza → ukisa
teatro → aktotela, tetero
teatrología → teatrologia
teatrólogo → teatrologo, teatrologette
techo → tecto
tecla → tekla
teclado →  teklatablo
tecnografía → teknografia, teknografica
tecnología → texnologia
tecnólogo → teknologo, teknologette
teja → teja
tejado → airplane
tejedora (máquina) → beilaoro
tejedora (persona) → beilaxette
tejido → beila
tejón → usetse
tela de araña → vesukila, vesuila, aracneta
tela → ila
telar → ilaoro
telefotografía → telefotografia, telefotografica
telegrafía → telegrafia, telegrafica
telekinesis → telekinetis, telekinesis
telemetría → telemetria, telemetrica
teleología → teleologia
telescopio → telescope
teletransporte → teleporte
televisión, televisor → televisoi
teléfono fijo → telefono tokla, guirofono, telefono guiro 
teléfono móvil, móvil → mobila, fone, fona
teléfono → telefono
telón → beiloxte
tema → subyecto
temblor → brusta
temperatura → tempera
templo → templo
temática → subyectata
tenaza → kratsa
tenazas, alicates → alicator
tenderete → loga
tendero, vendedor → venteixette
tenedor → tinera, trintso
tenencia, posesión → taina
tenis → tenis
tenista → tenista
tensión → tentia
teología → teologia
teratología → teratologia
terminal (sitio) → terminatela, terminal
terminología → terminologia
terminólogo → terminologo, terminologette
termografía → termografia, termografica
termogravimetría → termogravimetria, termogravimetrica
termología → termologia
termometría → termometria, termometrica
termómetro → termometera
ternera → ternera
ternero → ternero
ternura → aile
terracota → terracota
terraformación → terraforma
terraplén → terrapova
terraza → terraztela
terremoto → terraxatai
terreno → terranno
territorio → territoria
terror → terura, terrura
terrorista → terurasta, terrurasta
tesis → tesis
tesorero, buscador de tesoros → trisorette
tesoro, botín → trisor
test (examen) → test
testículo → testiclo, testiculo
teta → burra, tita
tetralogía → tetralogia
tetronimo → tetronimo
texto zalgo → zalgo
texto → sora, izkrebo
teólogo → teologo, teologette
tiburón → tsonder, esqalo
ticket → tike, tiqe, ticket
tiempo (clima) → vedo
tiempo → tempo
tienda → loga, logatela, kompraitela
tierra infértil → hace
tierra → terra
tiflología → tiflologia
tiflotecnología → tiflotecnologia
tiflólogo → tiflologo, tiflologette
tifón → tifona, tifon
tigre → tigra
tigrón → tigron
tijera → akutoro
tiki → tiki
tilde → tilde
timbre → pistila
timbrología → timbrologia
timbrólogo → timbrologo, timbrologette
tinta → tenta
tio, tia → teo
tipo (de tipo de cosa) → tipe
tipo (ejemplar) → klase
tipo (forma) → forma
tipo (referencia coloquial a una persona) → pal
tipografía → tipografia, tipografica
tipología → tipologia
tipometría → tipometria, tipometrica
tira → estriga
tirachinas → zroioro, eslingo
tiro → ata
tisiología → tisiologia
tisiólogo → tisiologo, tisiologette
titanio → titanno
titular → mantse
tiza → zirra
toalla → toaia
toallita → toaita
tobillo → kidna, anclo
tocología → tocologia
tocólogo → tocologo, tocologette
todoterreno → aldeterranno, forbafor
todólogo → todologo, todologette
tomate → tomako
tomillo → koki
tomografía → tomografia, tomografica
tono de móvil → fonetona
tono → tona
tonto → erko, silki, dulo, izbostava
topacio → topacio, topazio
topo → talpa, mola
topografía → topografia, topografica
topología → topologia, topologica
topógrafo → topografette
topólogo → topologette
toque → toutsa
torcecuellos → corloqibre, corlere
tormenta → zundra
tornado → tornado
torneo → torneio
tornillo → exkrabo
torno → torno
toro → toro
torpedo → torpedo
torre → torra, hatena
torrente → torrenza
torreta → torrata, turreta
torta → torta
tortilla → tortilla, omeleto
tortita → tortite
tortuga → tortoisa
tortura → apunda
tostada → tosta
tostadora → tostoro
total → aldo
totem → totem
toxicología → toksicologia
toxicólogo → toksicologo, toksicologette
trabajador → travaxette
trabajo → laboro, travaxo
trabalenguas → mixequeieto
traducción → translaio
traductor (objeto) → translaioro
traductor (persona) → translaixette
traficación → trafike
traficante → trafikaxette
tragedia → trajedia
traición → trasta
traje → gouno, esmokinno
tramitología → tramitologia
trampa → trapa, trapitsa
trance → trance
transcripción → transcriba
transexual → transexualo
transexualidad → transexualita
transfobia → transfobia
transmutación → transmuta
transportador (regla) → aconvo
transporte → conve
tranvía → ciutrena, trama, tram
traspiés → troin
trastero → celara, trastela
trasto → traste
trastorno → yiga
tratado → trato, tratado
trato → tiska, trato, trao
trauma → trauma
traumatología → traumatologia
traumatólogo → traumatologo, traumatologette
travesura → inkinda
travieso → inkinde
traza → traza
tren → trena
trenza → trence
tres en raya → exo, exou, triaiette
tres → triai
triatlon → triatlon
tribología → tribologia
tribu → tribu
tributo → tributo, tribute
triciclo → trirroda
tridente → tridento
trigo → trego
trigonometría → trigonometria, trigonometrica
trilingüe → trilingo
trilogía → trilogia
trinchera → trintsera
tripa → tripa
tripofobia → tripofobia
trismo → trisma
tristeza → tristaga
tristeza → tristekia
trituradora → trituoro
tritón → uale
trivia → trivia
triángulo → trianglo
trofeo → trofeio
trofología → trofologia
trofólogo → trofologo, trofologette
troglodítido → olve
trompa → trompo
trompeta → trompeta
tronco → trunko
trono → trone
tropa → tropas
tropología → tropologia
trucha → trutsa
truco → truka, trapitsa
trueno → trumbe
trufa → turfa
tráfico → trafiko
tránsito → transita
trébol → trebola
tréboles (palo de póker) → trebola
trío (mano de póker) → triai equalit
trío → trio
tríplex → triplex
trópico → tropiko
tsunami → tsunami, tzunami, zunami
tubería → tubia
tubo → tube
tubérculo → tuberculo 
tucán → tuca, ranfa, tucan
tuerca → exkronno
tulipán → atulipa
tumba → tumba
tumor → tumor
tundra → kolfisi
tungsteno, wolframio → tunsten, wolfram
tupla → tupla
turismo → turisma
turismofobia → turismofobia
turista → turista
turno → turno
turrón → bengela
tándem → tandem
té purpur tipico aidanés → purpur tsa, tsa purpur
té → tsa
técnica → texna
técnico → texnette
término → termino
tímpano → timpano
tío → benpai
título → titula
ualabí → gualabi, walabi
ubicación → ubikatio, locato
ucraniano → ukraneo
ufología → ufologia
ufólogo → ufologo, ufologette
ultílogo → ultilogo, ultilogette
un supuesto reloj interno de una persona el cual se creía en la antiguedad que generaba los impulsos en gente impulsiva → pneupuloi
universidad → formatio-zentro
universo → universo
unión → unione, yoixo
uno → one
uranio → uranio
uranografía → uranografia, uranografica
uranometría → uranometria, uranometrica
urbanización → urbo
uretra → uretra
urgenciólogo → urgenciologo, urgenciologette
urial → bovo, urial
urografía → urografia, urografica
urología → urologia
uróboros → ouroboros
urólogo → urologo, urologette
uso → use
usuario → usuario
utero → utero
utilidad → utilidae
utopía → utopia
uva → uba
uña → neka
vaca → vaka
vacunología → vacunologia
vacunólogo → vacunologo, vacunologette
vacío → aucuo, vacuos
vagabundo → vagabondo
vago → sugarra
vagón → bagon, wagon
vajilla → vadixa
validez → valita
valla → berja, fenza
valle → vale, imporas, impora
valor (tener fuerza de voluntad) → valia
valor (valor de algo) → valua
vampiro → vampiro
vanidad → vanita
vaquero → vakette, bukaru, cowboy, vakero
variable → variable
varita → vando
vasallaje → vasaia
vasallo → vasaio
vascólogo → vascologo, vascologette
vasija → vasiya
vaso → cupa
vecindario → seranotela, neiborotela
vecino → serano, neiboro
vegetal → vegeto
vehículo → vehiklo
vejez → igernesa, okosa, okoie, eldesa
vela (barco) → vela
vela (objeto para iluminar) → candala
velcro → velcro
velero → sivera
velocidad → velocita
velociraptor → velociraptor
vena → sigraconve, siger
vencejo, salangana → venzo, burlo
venda → ladepipra, bande
vendaje → bandeje
vendedor → ventette
veneno → venemo, ponzo
venereología → venereologia
venereólogo → venereologo, venereologette
venganza → revenga, revenganze, retributio, venganze
venta → venta
ventaja → alanco
ventana → vendexa
ventilador de pie → estanvendo
ventilador de techo → tecvendo, tectovendoioro, tectovendo
ventilador → vendoioro
ventriculografía → ventriculografia, ventriculografica
ventrilocuo → vintrelocuo
verano → solasta
verbo → verba
verdad → verdad
verdura → leguma
vergüenza → combro
verificación → verifia
verruga → burgua
versión → versiona
vertedero → zorrotela, desextela
vestido → venaza, dreso, gouno, zitaba
vestimenta → venaza
vestíbulo → tsambela, foyer, tsambel, tsamba, lobi
veto → bana, paina, paine
vexilología → vexilogia
vexilólogo → vexilogette
vez → meto
viaje en las drogas → wonderlan, trip, tripi
viaje → vixe
vibración → vibratia
vibrador → vibraibo
victoria → victoria
vicuña → vicunna
vida → vita
video → vidio
videoconsola → jokonsola
videojuego → vidiojoko
vieira → cola
viento → vendo
vientre → vintre
viga → felton, ferra
villa → vila
vinagre → vinagra
vinilo → vinilo
vino → vino
violeta → violeta
violín → violinne
virgen → virgo
virginidad → virginitae
virología → virologia
viruela → viraela
virus → virus
virólogo → virologo, virologette
visado → visado
viscosimetría → viscosimetria, viscosimetrica
visión → viso
vista → vista
visualización → visoatio
visón → orgon
vitalidad → vitalita
vitamina → vitamine
viuda negra → viutonekro
viudo, viuda → viuto
vivienda → vivaitela
vocabulario → vokabulatio
vocal → vokal
vocina → vocine
volante (coche) → volante
volante (papel) → piprako
volcán → volkano
volumetría → volumetria, volumetrica
voluntad → volunta
volúmen → voluma
voyeurista → voyeurette, voyeur, voyeurista
voz → voz
vuelo → blaia
vuelta → vira
vulcanología → vulcanologia, volkanologia
vulcanólogo → vulcanologo, vulcanologette, volkanologo, volkanologette
vulva → vulve
váscula → vascula
váter, retrete → batro, baxete, vater
vía → kemno
vía → via
víbora → veno
víctima → viktima
vídeo → vidio
víspera de día → henito
víspera de festivo → ferehenita
vóxel → voxel
web → web
whisky → wiski
wikipedia → wikipedia
wolfsbane → volsvein, wolfsbane
wombat → vombat
xenofobia → xenofobia
xenón → xenon
xerografía → kserografia, kserografica
xilografía → ksilografia, ksilografica
xilófono → xelofono
yak → yak
yate → yate
yegüa → yequa
yero, algarroba → yero
yoga → yoga
yogur → yogur
yoyo → yoyo
yunque → herrunna
zanahoria → carrota
zapatilla, zapato → poire
zar → zar
zarigüeya → berno
zinc, cinc → cinc, cink
zincografía → zincografia, zincografica
zodiaco → zodia, zodiako
zombie → zombie
zona → zone
zoo → zoo
zoofilia → zoofilia
zoofobia → zoofobia
zoogeografía → zoogeografia, zoogeografica
zoografía → zoografia, zoografica
zoología → zoologia
zoológico → zoologiko
zoopsicología → zoopsicologia
zorro → zunio, fokso
zoólogo → zoologo, zoologette
zulo → crumbo
zumbido → biz
zumo de naranja → oranjela
zumo → xugino, bubo
zócalo → sokete
África → Afrika
Árabe → Arabeka
ácaro → atiko
águila → egila
álamo → klisila
ámbar → ambar
ángel → anyel
árbol mágico → traxhaia
árbol → arbotso, traxe
ático → atike, airgaizera
época → elkara
éter → eter
ética → etika
ícor → icor
ídolo → idola
índigo → indigo
ñú → legas
óculo → oculo
óleo → oliuma
órbita → orbita
ósmosis → osmosis
óvalo → oval
óvulo → ovulo
óxido → ragi
úlcera → ulcera
último → finale